ក	kɑɑ
ខ	kʰɑɑ
គ	kɔɔ
ឃ	kʰɔɔ
ង	ŋɔɔ
ច	cɑɑ
ឆ	cʰɑɑ
ជ	cɔɔ
ឈ	cʰɔɔ
ញ	ɲɔɔ
ដ	ɗɑɑ
ឋ	tʰɑɑ
ឌ	ɗɔɔ
ឍ	tʰɔɔ
ណ	nɑɑ
ត	tɑɑ
ថ	tʰɑɑ
ទ	tɔɔ
ធ	tʰɔɔ
ន	nɔɔ
ប	ɓɑɑ
ផ	pʰɑɑ
ព	pɔɔ
ភ	pʰɔɔ
ម	mɔɔ
យ	jɔɔ
រ	rɔɔ
ល	lɔɔ
វ	wɔɔ
ស	sɑɑ
ហ	hɑɑ
ឡ	lɑɑ
អ	ʔɑɑ
កក	kɑɑk
កង	kɑɑŋ
កន	kɑɑn
កប	kɑɑp
កម	kɑɑm
កា	kaa
កី	kəj
កើ	kaə
កែ	kae
កៃ	kaj
ខក	kʰɑɑk
ខន	kʰɑɑn
ខម	kʰɑɑm
ខួ	kʰuə
ខេ	kʰee
ខែ	kʰae
ខៃ	kʰaj
ខោ	kʰao
ខំ	kʰɑm
ខះ	kʰah
គក	kɔɔk
គង	kɔɔŋ
គន	kɔɔn
គម	kɔɔm
គយ	kɔɔj
គរ	kɔɔ
គី	kii
គឺ	kɨɨ
គូ	kuu
គែ	kɛɛ
គៃ	kej
គំ	kum
ងរ	ŋɔɔ
ងា	ŋie
ងឺ	ŋɨɨ
ងឿ	ŋɨə
ងៅ	ŋɨw
ងំ	ŋum
ចក	cɑɑk
ចង	cɑɑŋ
ចត	cɑɑt
ចប	cɑɑp
ចម	cɑɑm
ចែ	cae
ចៃ	caj
ចៅ	caw
ចំ	cɑm
ឆក	cʰɑɑk
ឆត	cʰɑɑt
ឆប	cʰɑɑp
ឆរ	cʰɑɑ
ឆា	cʰaa
ឆី	cʰəj
ឆែ	cʰae
ឆៅ	cʰaw
ជង	cɔɔŋ
ជត	cɔɔt
ជន	cɔɔn
ជម	cɔɔm
ជរ	cɔɔ
ជា	cie
ជី	cii
ជួ	cuə
ជើ	cəə
ជឿ	cɨə
ជៅ	cɨw
ជំ	cum
ជះ	ceah
ឈប	cʰɔɔp
ឈម	cʰɔɔm
ឈរ	cʰɔɔ
ឈឺ	cʰɨɨ
ឈូ	cʰuu
ឈើ	cʰəə
ញក	ɲɔɔk
ញន	ɲɔɔn
ញប	ɲɔɔp
ញយ	ɲɔɔj
ញី	ɲii
ញំ	ɲum
ដក	ɗɑɑk
ដង	ɗɑɑŋ
ដប	ɗɑɑp
ដម	ɗɑɑm
ដរ	ɗɑɑ
ដា	ɗaa
ដី	ɗəj
ដៃ	ɗaj
ដៅ	ɗaw
ដំ	ɗɑm
ឌឺ	ɗɨɨ
ណា	naa
ណែ	nae
តង	tɑɑŋ
តប	tɑɑp
តម	tɑɑm
តយ	tɑɑj
តា	taa
តុ	toʔ
តួ	tuə
តើ	taə
តឿ	tɨə
តែ	tae
តោ	tao
តៅ	taw
តះ	tah
ថង	tʰɑɑŋ
ថត	tʰɑɑt
ថយ	tʰɑɑj
ថា	tʰaa
ថូ	tʰoo
ថួ	tʰuə
ថែ	tʰae
ថៃ	tʰaj
ថោ	tʰao
ទក	tɔɔk
ទង	tɔɔŋ
ទត	tɔɔt
ទម	tɔɔm
ទយ	tɔɔj
ទរ	tɔɔ
ទា	tie
ទី	tii
ទូ	tuu
ទួ	tuə
ទេ	tee
ទៃ	tej
ទៅ	tɨw
ទំ	tum
ទះ	teah
ធឺ	tʰɨɨ
ធួ	tʰuə
ធំ	tʰum
នក	nɔɔk
នប	nɔɔp
នា	nie
នី	nii
នែ	nɛɛ
នៃ	nej
នៅ	nɨw
នំ	num
បក	ɓɑɑk
បង	ɓɑɑŋ
បន	ɓɑɑn
បម	ɓɑɑm
បរ	ɓɑɑ
បី	ɓəj
បូ	ɓoo
បួ	ɓuə
បើ	ɓaə
បៀ	ɓiə
បៅ	ɓaw
បះ	ɓah
ប៉	pɑɑ
ប៊	ɓɔɔ
ផង	pʰɑɑŋ
ផត	pʰɑɑt
ផស	pʰɑɑh
ផែ	pʰae
ផៅ	pʰaw
ពក	pɔɔk
ពង	pɔɔŋ
ពន	pɔɔn
ពម	pɔɔm
ពយ	pɔɔj
ពី	pii
ពូ	puu
ពើ	pəə
ពែ	pɛɛ
ពៃ	pej
ពោ	poo
ពៅ	pɨw
ពះ	peah
ភយ	pʰɔɔj
ភរ	pʰɔɔ
ភី	pʰii
ភូ	pʰuu
ភើ	pʰəə
ភេ	pʰee
មក	mɔɔk
មង	mɔɔŋ
មន	mɔɔn
មរ	mɔɔ
មា	mie
មី	mii
មួ	muə
មើ	məə
មេ	mee
មែ	mɛɛ
មៃ	mej
មៅ	mɨw
យក	jɔɔk
យី	jii
យើ	jəə
យៃ	jej
យោ	joo
យៅ	jɨw
យំ	jum
យះ	jeah
យ៉	jɑɑ
រក	rɔɔk
រង	rɔɔŋ
រត	rɔɔt
រន	rɔɔn
រប	rɔɔp
រម	rɔɔm
រយ	rɔɔj
រល	rɔɔl
រហ	rɔɔh
រឡ	rɔɔl
រា	rie
រី	rii
រូ	ruu
រើ	rəə
រឿ	rɨə
រេ	ree
រៃ	rej
រំ	rum
រះ	reah
រ៉	rɑɑ
លក	lɔɔk
លង	lɔɔŋ
លត	lɔɔt
លន	lɔɔn
លប	lɔɔp
លម	lɔɔm
លយ	lɔɔj
លា	lie
លី	lii
លឺ	lɨɨ
លូ	luu
លើ	ləə
លែ	lɛɛ
លៃ	lej
លោ	loo
លៅ	lɨw
លំ	lum
លះ	leah
វក	wɔɔk
វង	wɔɔŋ
វរ	wɔɔ
វា	wie
វឺ	wɨɨ
វូ	wuu
វៃ	wej
វោ	woo
វះ	weah
វ៉	wɑɑ
សក	sɑɑk
សង	sɑɑŋ
សប	sɑɑp
សម	sɑɑm
សយ	sɑɑj
សា	saa
សី	səj
សឺ	səə
សូ	soo
សួ	suə
សើ	saə
សៀ	siə
សេ	see
សែ	sae
សោ	sao
សៅ	saw
សំ	sɑm
សះ	sah
ហក	hɑɑk
ហង	hɑɑŋ
ហប	hɑɑp
ហស	hɑɑh
ហា	haa
ហឺ	həə
ហៀ	hiə
ហេ	hee
ហែ	hae
ហោ	hao
ហំ	hɑm
ហ៊	hɔɔ
ឡក	lɑɑk
ឡង	lɑɑŋ
ឡត	lɑɑt
ឡូ	loo
ឡែ	lae
ឡោ	lao
ឡៅ	law
ឡះ	lah
អក	ʔɑɑk
អង	ʔɑɑŋ
អញ	ʔɑɑɲ
អត	ʔɑɑt
អន	ʔɑɑn
អម	ʔɑɑm
អរ	ʔɑɑ
អា	ʔaa
អី	ʔəj
អឺ	ʔəə
អូ	ʔoo
អួ	ʔuə
អើ	ʔaə
អៀ	ʔiə
អែ	ʔae
អៃ	ʔaj
អះ	ʔah
កករ	kɑ\.kɑɑ
កក់	kɑk
កង់	kɑŋ
កដប	kɑ\.ɗɑɑp
កណា	kɑ\.naa
កត់	kɑt
កប់	kɑp
កល់	kɑl
កាក	kaak
កាង	kaaŋ
កាច	kaac
កាត	kaat
កាប	kaap
ការ	kaa
កាវ	kaaw
កាស	kaah
កាំ	kam
កិង	kəŋ
កិត	kət
កិន	kən
កិប	kəp
កិល	kəl
កឹះ	kəh
កុក	kok
កុង	koŋ
កុញ	koɲ
កុន	kon
កុប	kop
កុយ	koj
កុរ	ko
កុំ	kom
កុះ	koh
កូត	koot
កូន	koon
កូប	koop
កូរ	koo
កូវ	koow
កួច	kuəc
កួត	kuət
កួន	kuən
កួយ	kuəj
កួរ	kuə
កើង	kaəŋ
កើច	kaəc
កើត	kaət
កើន	kaən
កើប	kaəp
កើយ	kaəj
កើល	kaəl
កឿង	kɨəŋ
កៀក	kiək
កៀង	kiəŋ
កៀច	kiəc
កៀត	kiət
កៀន	kiən
កៀប	kiəp
កៀរ	kiə
កៀវ	kiəw
កៀស	kiəh
កេក	keek
កេង	keeŋ
កេរ	kee
កេល	keel
កេវ	keew
កេះ	keh
កែក	kaek
កែង	kaeŋ
កែន	kaen
កែប	kaep
កែម	kaem
កែវ	kaew
កែស	kaeh
កែះ	kaeh
កោក	kaok
កោង	kaoŋ
កោត	kaot
កោន	kaon
កោប	kaop
កោយ	kaoj
កោរ	kao
កោស	kaoh
កោះ	kɑh
ក្ង	kŋɑɑ
ក្ដ	kɗɑɑ
ក្រ	krɑɑ
ខក់	kʰɑk
ខន់	kʰɑn
ខាក	kʰaak
ខាង	kʰaaŋ
ខាត	kʰaat
ខាន	kʰaan
ខាប	kʰaap
ខាម	kʰaam
ខារ	kʰaa
ខាល	kʰaal
ខាវ	kʰaaw
ខាំ	kʰam
ខិង	kʰəŋ
ខិត	kʰət
ខិម	kʰəm
ខិល	kʰəl
ខឹក	kʰək
ខឹង	kʰəŋ
ខុង	kʰoŋ
ខុន	kʰon
ខុប	kʰop
ខុយ	kʰoj
ខុរ	kʰo
ខុល	kʰol
ខុស	kʰoh
ខូង	kʰooŋ
ខូច	kʰooc
ខួង	kʰuəŋ
ខួច	kʰuəc
ខួញ	kʰuəɲ
ខួប	kʰuəp
ខួរ	kʰuə
ខើច	kʰaəc
ខឿន	kʰɨən
ខៀន	kʰiən
ខៀវ	kʰiəw
ខេន	kʰeen
ខែង	kʰaeŋ
ខែល	kʰael
ខោក	kʰaok
ខោរ	kʰao
ខោល	kʰaol
ខោស	kʰaoh
ខ្ព	kpɔɔ
គក់	kuək
គឃរ	kɔ\.kʰɔɔ
គង់	kuŋ
គជ់	kuc
គត់	kut
គន់	kun
គប់	kup
គល់	kul
គាង	kieŋ
គាប	kiep
គាយ	kiej
គាវ	kiew
គាំ	koam
គិត	kɨt
គិល	kɨl
គឹក	kɨk
គឹល	kɨl
គុក	kuk
គុត	kut
គុន	kun
គុយ	kuj
គុល	kul
គុំ	kum
គូក	kuuk
គូរ	kuu
គូស	kuuh
គួប	kuəp
គួរ	kuə
គើម	kəəm
គេង	keeŋ
គេច	keec
គែន	kɛɛn
គែប	kɛɛp
គែម	kɛɛm
គែល	kɛɛl
គោក	kook
គោង	kooŋ
គោត	koot
គោម	koom
គោះ	kuəh
គ្រ	krɔɔ
ឃាង	kʰieŋ
ឃឹក	kʰɨk
ឃឹម	kʰɨm
ឃុន	kʰun
ឃុំ	kʰum
ឃូរ	kʰuu
ឃូស	kʰuuh
ឃើញ	kʰəəɲ
ឃែត	kʰɛɛt
ងក់	ŋuək
ងប់	ŋup
ងាក	ŋiek
ងាយ	ŋiej
ងារ	ŋie
ងាវ	ŋiew
ងាស	ŋieh
ងាំ	ŋoam
ងីក	ŋiik
ងីវ	ŋiiw
ងឹល	ŋɨl
ងូង	ŋuuŋ
ងូត	ŋuut
ងូស	ŋuuh
ងើត	ŋəət
ងើប	ŋəəp
ងើយ	ŋəəj
ងឿក	ŋɨək
ងឿង	ŋɨəŋ
ងៀង	ŋiəŋ
ងៀត	ŋiət
ងោក	ŋook
ងោង	ŋooŋ
ងោច	ŋooc
ងោះ	ŋuəh
ង៉ៃ	ŋaj
ង៉ៅ	ŋaw
ចក់	cɑk
ចង់	cɑŋ
ចចក	cɑ\.cɑɑk
ចត់	cɑt
ចប់	cɑp
ចាក	caak
ចាង	caaŋ
ចាន	caan
ចាប	caap
ចាម	caam
ចាយ	caaj
ចារ	caa
ចាល	caal
ចាវ	caaw
ចាស	caah
ចាំ	cam
ចិក	cək
ចិត	cət
ចិន	cən
ចឹក	cək
ចឹប	cəp
ចឹស	cəh
ចឺន	cəən
ចឺម	cəəm
ចុក	cok
ចុង	coŋ
ចុច	coc
ចុន	con
ចុយ	coj
ចុះ	coh
ចូក	cook
ចូរ	coo
ចូល	cool
ចួន	cuən
ចួប	cuəp
ចើក	caək
ចើស	caəh
ចៀន	ciən
ចៀម	ciəm
ចៀរ	ciə
ចៀស	ciəh
ចេក	ceek
ចេច	ceec
ចេញ	ceeɲ
ចេប	ceep
ចេរ	cee
ចេស	ceeh
ចេះ	ceh
ចែក	caek
ចែង	caeŋ
ចែត	caet
ចែវ	caew
ចែស	caeh
ចោត	caot
ចោម	caom
ចោល	caol
ចោះ	cɑh
ចំណ	cɑm\.nɑɑ
ចំហ	cɑm\.hɑɑ
ឆក់	cʰɑk
ឆាក	cʰaak
ឆាង	cʰaaŋ
ឆាប	cʰaap
ឆាយ	cʰaaj
ឆាវ	cʰaaw
ឆិញ	cʰəɲ
ឆិត	cʰət
ឆិល	cʰəl
ឆឹក	cʰək
ឆឹង	cʰəŋ
ឆឺង	cʰəəŋ
ឆុក	cʰok
ឆុង	cʰoŋ
ឆុត	cʰot
ឆូត	cʰoot
ឆូវ	cʰoow
ឆួង	cʰuəŋ
ឆួល	cʰuəl
ឆើត	cʰaət
ឆើយ	cʰaəj
ឆៀក	cʰiək
ឆៀង	cʰiəŋ
ឆៀប	cʰiəp
ឆេញ	cʰeeɲ
ឆេរ	cʰee
ឆេវ	cʰeew
ឆេះ	cʰeh
ឆែក	cʰaek
ឆែង	cʰaeŋ
ឆែត	cʰaet
ឆែប	cʰaep
ឆែវ	cʰaew
ឆោង	cʰaoŋ
ឆោត	cʰaot
ឆោម	cʰaom
ឆ្វ	cwɑɑ
ជក់	cuək
ជង់	cuŋ
ជច់	cuc
ជន់	cun
ជប់	cup
ជល់	cul
ជាង	cieŋ
ជាម	ciem
ជាយ	ciej
ជាវ	ciew
ជាស	cieh
ជាំ	coam
ជិត	cɨt
ជិន	cɨn
ជិប	cɨp
ជិះ	cih
ជីក	ciik
ជីប	ciip
ជុក	cuk
ជុច	cuc
ជុំ	cum
ជុះ	cuh
ជូត	cuut
ជូន	cuun
ជូរ	cuu
ជួង	cuəŋ
ជួញ	cuəɲ
ជួត	cuət
ជួន	cuən
ជួប	cuəp
ជួយ	cuəj
ជួរ	cuə
ជួល	cuəl
ជួស	cuəh
ជើង	cəəŋ
ជើត	cəət
ជើយ	cəəj
ជឿន	cɨən
ជៀត	ciət
ជៀន	ciən
ជៀប	ciəp
ជៀវ	ciəw
ជៀស	ciəh
ជេន	ceen
ជេរ	cee
ជេះ	ceh
ជែក	cɛɛk
ជែង	cɛɛŋ
ជែះ	cɛh
ជោក	cook
ជោរ	coo
ជោះ	cuəh
ឈប់	cʰup
ឈាន	cʰien
ឈាម	cʰiem
ឈាវ	cʰiew
ឈិង	cʰɨŋ
ឈឹង	cʰɨŋ
ឈឹប	cʰɨp
ឈុត	cʰut
ឈូក	cʰuuk
ឈូង	cʰuuŋ
ឈូច	cʰuuc
ឈែល	cʰɛɛl
ឈោង	cʰooŋ
ញក់	ɲuək
ញច់	ɲuc
ញញី	ɲɔ\.ɲii
ញល់	ɲul
ញាំ	ɲoam
ញឹក	ɲɨk
ញឹន	ɲɨn
ញុះ	ɲuh
ញូញ	ɲuuɲ
ញើញ	ɲəəɲ
ញើប	ɲəəp
ញើស	ɲəəh
ញៀច	ɲiəc
ញៀត	ɲiət
ញៀន	ɲiən
ញេច	ɲeec
ញេញ	ɲeeɲ
ញែក	ɲɛɛk
ញោច	ɲooc
ញោម	ɲoom
ញោស	ɲooh
ញោះ	ɲuəh
ញ៉ម	ɲɑɑm
ញ៉ែ	ɲae
ដកព	ɗɑ\.kɑɑp
ដក់	ɗɑk
ដទៃ	ɗɑ\.tej
ដប់	ɗɑp
ដល់	ɗɑl
ដាង	ɗaaŋ
ដាច	ɗaac
ដាន	ɗaan
ដាប	ɗaap
ដាម	ɗaam
ដាយ	ɗaaj
ដាល	ɗaal
ដាវ	ɗaaw
ដាស	ɗaah
ដាំ	ɗam
ដិត	ɗət
ដីស	ɗəjh
ដឹក	ɗək
ដឹង	ɗəŋ
ដឹប	ɗəp
ដឹស	ɗəh
ដុត	ɗot
ដុន	ɗon
ដុប	ɗop
ដុល	ɗol
ដុស	ɗoh
ដុំ	ɗom
ដុះ	ɗoh
ដូង	ɗooŋ
ដូច	ɗooc
ដូន	ɗoon
ដូរ	ɗoo
ដួង	ɗuəŋ
ដួច	ɗuəc
ដួន	ɗuən
ដួល	ɗuəl
ដួស	ɗuəh
ដើម	ɗaəm
ដើរ	ɗaə
ដៀង	ɗiəŋ
ដៀប	ɗiəp
ដៀល	ɗiəl
ដៀវ	ɗiəw
ដេក	ɗeek
ដេញ	ɗeeɲ
ដេរ	ɗee
ដែក	ɗaek
ដែង	ɗaeŋ
ដែន	ɗaen
ដែរ	ɗae
ដែល	ɗael
ដោក	ɗaok
ដោច	ɗaoc
ដោប	ɗaop
ដោម	ɗaom
ដោយ	ɗaoj
ដោរ	ɗao
ដោល	ɗaol
ដោះ	ɗɑh
ដំប	ɗɑm\.ɓɑɑ
ឌិន	ɗɨn
ឌុន	ɗun
ណាយ	naaj
ណិល	nəl
ណឺង	nəəŋ
ណូង	nooŋ
ណែន	naen
ណែម	naem
ណែវ	naew
តក់	tɑk
តន់	tɑn
តបះ	tɑ\.ɓah
តប់	tɑp
តាក	taak
តាង	taaŋ
តាច	taac
តាត	taat
តាន	taan
តាប	taap
តាម	taam
តិច	təc
តិះ	teh
តឹក	tək
តឹង	təŋ
តុង	toŋ
តុញ	toɲ
តុប	top
តុះ	toh
តូង	tooŋ
តូច	tooc
តូន	toon
តូប	toop
តួច	tuəc
តួន	tuən
តួម	tuəm
តើក	taək
តើត	taət
តើន	taən
តើយ	taəj
តឿន	tɨən
តៀង	tiəŋ
តៀន	tiən
តៀប	tiəp
តៀម	tiəm
តេត	teet
តេន	teen
តែង	taeŋ
តែម	taem
តោក	taok
តោង	taoŋ
តោន	taon
តោះ	tɑh
តំណ	tɑm\.nɑɑ
ត្រ	trɑɑ
ថង់	tʰɑŋ
ថប់	tʰɑp
ថាវ	tʰaaw
ថាស	tʰaah
ថាំ	tʰam
ថុច	tʰoc
ថួន	tʰuən
ថើប	tʰaəp
ថឿក	tʰɨək
ថេរ	tʰee
ថែប	tʰaep
ថែម	tʰaem
ថែវ	tʰaew
ថោះ	tʰɑh
ថ្ង	tŋɑɑ
ថ្ម	tmɑɑ
ទក់	tuək
ទង់	tuŋ
ទច់	tuc
ទញ់	tuɲ
ទទា	tɔ\.tie
ទទេ	tɔ\.tee
ទទែ	tɔ\.tɛɛ
ទទះ	tɔ\.teah
ទន់	tun
ទប់	tup
ទល់	tul
ទស់	tuəh
ទាក	tiek
ទាង	tieŋ
ទាច	tiec
ទាញ	tieɲ
ទាន	tien
ទាប	tiep
ទាយ	tiej
ទារ	tie
ទាល	tiel
ទាស	tieh
ទាំ	toam
ទិច	tɨc
ទិញ	tɨɲ
ទិល	tɨl
ទីង	tiiŋ
ទីវ	tiiw
ទឹង	tɨŋ
ទឹប	tɨp
ទឹល	tɨl
ទឺង	tɨɨŋ
ទឺះ	tɨɨh
ទុក	tuk
ទុង	tuŋ
ទុន	tun
ទុំ	tum
ទូក	tuuk
ទូង	tuuŋ
ទូច	tuuc
ទូញ	tuuɲ
ទូរ	tuu
ទូល	tuul
ទួង	tuəŋ
ទួញ	tuəɲ
ទួត	tuət
ទួន	tuən
ទួម	tuəm
ទួល	tuəl
ទើង	təəŋ
ទើត	təət
ទើប	təəp
ទើម	təəm
ទើរ	təə
ទើស	təəh
ទៀត	tiət
ទៀន	tiən
ទៀប	tiəp
ទៀវ	tiəw
ទេញ	teeɲ
ទេរ	tee
ទែង	tɛɛŋ
ទែន	tɛɛn
ទែព	tɛɛp
ទែះ	tɛh
ទោង	tooŋ
ទោច	tooc
ទោម	toom
ទោរ	too
ទោល	tool
ទោះ	tuəh
ទ្រ	trɔɔ
ធន់	tʰun
ធាង	tʰieŋ
ធាន	tʰien
ធីប	tʰiip
ធឹង	tʰɨŋ
ធុង	tʰuŋ
ធុន	tʰun
ធុំ	tʰum
ធូរ	tʰuu
ធួន	tʰuən
ធៀប	tʰiəp
ធេង	tʰeeŋ
ននល	nɔ\.nɔɔl
ននះ	nɔ\.neah
នប់	nup
នាង	nieŋ
នាច	niec
នារ	nie
នាល	niel
នាវ	niew
នាំ	noam
និង	nɨŋ
នឹក	nɨk
នឹង	nɨŋ
នឹម	nɨm
នុយ	nuj
នុះ	nuh
នូវ	nuuw
នួត	nuət
នួន	nuən
នឿក	nɨək
នឿយ	nɨəj
នៀវ	niəw
នេន	neen
នេះ	neh
នែប	nɛɛp
នោប	noop
នោម	noom
នោះ	nuəh
បក់	ɓɑk
បង់	ɓɑŋ
បត់	ɓɑt
បន់	ɓɑn
បបរ	ɓɑ\.ɓɑɑ
បាង	ɓaaŋ
បាច	ɓaac
បាញ	ɓaaɲ
បាត	ɓaat
បាន	ɓaan
បាយ	ɓaaj
បារ	ɓaa
បាវ	ɓaaw
បិត	ɓət
បឹង	ɓəŋ
បឹម	ɓəm
បឺត	ɓəət
បឺះ	ɓəəh
បុក	ɓok
បុល	ɓol
បុះ	ɓoh
បូក	ɓook
បូញ	ɓooɲ
បូត	ɓoot
បូម	ɓoom
បូល	ɓool
បូស	ɓooh
បួង	ɓuəŋ
បួន	ɓuən
បួរ	ɓuə
បួល	ɓuəl
បួស	ɓuəh
បើក	ɓaək
បឿន	ɓɨən
បៀក	ɓiək
បៀត	ɓiət
បៀម	ɓiəm
បៀរ	ɓiə
បេង	ɓeeŋ
បេះ	ɓeh
បែក	ɓaek
បែង	ɓaeŋ
បែន	ɓaen
បែប	ɓaep
បែរ	ɓae
បោក	ɓaok
បោង	ɓaoŋ
បោច	ɓaoc
បោប	ɓaop
បោយ	ɓaoj
បោរ	ɓao
បោល	ɓaol
បោស	ɓaoh
បោះ	ɓɑh
ប៉ក	pɑɑk
ប៉ង	pɑɑŋ
ប៉ច	pɑɑc
ប៉ម	pɑɑm
ប៉យ	pɑɑj
ប៉ី	pəj
ប៉ែ	pae
ប៉ៃ	paj
ប៉ោ	pao
ប៉ៅ	paw
ប៉ះ	pah
ផង់	pʰɑŋ
ផាក	pʰaak
ផាង	pʰaaŋ
ផាយ	pʰaaj
ផាវ	pʰaaw
ផាស	pʰaah
ផិត	pʰət
ផឹក	pʰək
ផឹង	pʰəŋ
ផឺត	pʰəət
ផុង	pʰoŋ
ផុត	pʰot
ផុយ	pʰoj
ផុរ	pʰo
ផុស	pʰoh
ផូក	pʰook
ផូង	pʰooŋ
ផូយ	pʰooj
ផូស	pʰooh
ផួយ	pʰuəj
ផើង	pʰaəŋ
ផើត	pʰaət
ផើម	pʰaəm
ផើយ	pʰaəj
ផឿក	pʰɨək
ផេង	pʰeeŋ
ផេរ	pʰee
ផេះ	pʰeh
ផែង	pʰaeŋ
ផែត	pʰaet
ផែន	pʰaen
ផែល	pʰael
ផែះ	pʰaeh
ផោង	pʰaoŋ
ផោម	pʰaom
ពញា	pɔ\.ɲie
ពត់	put
ពន់	pun
ពពក	pɔ\.pɔɔk
ពពូ	pɔ\.puu
ពពែ	pɔ\.pɛɛ
ពភល	pɔ\.pʰɔɔl
ពស់	puəh
ពាង	pieŋ
ពាត	piet
ពាន	pien
ពាម	piem
ពាយ	piej
ពាស	pieh
ពាំ	poam
ពិត	pɨt
ពិន	pɨn
ពិល	pɨl
ពីង	piiŋ
ពីរ	pii
ពឹង	pɨŋ
ពឹត	pɨt
ពឹប	pɨp
ពឺត	pɨɨt
ពុក	puk
ពុង	puŋ
ពុត	put
ពុន	pun
ពុប	pup
ពុរ	pu
ពុល	pul
ពុំ	pum
ពុះ	puh
ពូក	puuk
ពូត	puut
ពូន	puun
ពួក	puək
ពួច	puəc
ពួត	puət
ពួន	puən
ពួយ	puəj
ពួរ	puə
ពើក	pəək
ពើង	pəəŋ
ពើត	pəət
ពើប	pəəp
ពើម	pəəm
ពៀច	piəc
ពៀប	piəp
ពេក	peek
ពេញ	peeɲ
ពេន	peen
ពេប	peep
ពែង	pɛɛŋ
ពែន	pɛɛn
ពោង	pooŋ
ពោត	poot
ពោន	poon
ពោប	poop
ពោរ	poo
ពោល	pool
ពោះ	puəh
ភក់	pʰuək
ភប់	pʰup
ភាន	pʰien
ភាយ	pʰiej
ភារ	pʰie
ភាវ	pʰiew
ភិត	pʰɨt
ភិល	pʰɨl
ភីង	pʰiiŋ
ភឹង	pʰɨŋ
ភឹប	pʰɨp
ភឹល	pʰɨl
ភឺត	pʰɨɨt
ភឺន	pʰɨɨn
ភឺស	pʰɨɨh
ភុង	pʰuŋ
ភុយ	pʰuj
ភុល	pʰul
ភូស	pʰuuh
ភូះ	pʰuuh
ភួង	pʰuəŋ
ភួយ	pʰuəj
ភើច	pʰəəc
ភើត	pʰəət
ភឿន	pʰɨən
ភៀស	pʰiəh
ភេល	pʰeel
មត់	mut
មមី	mɔ\.mii
មមើ	mɔ\.məə
មមែ	mɔ\.mɛɛ
មមៃ	mɔ\.mej
មយី	mɔ\.jii
មរណ	mɔ\.rɔɔn
មាន	mien
មាំ	moam
មិច	mɨc
មិន	mɨn
មីង	miiŋ
មីរ	mii
មឹក	mɨk
មឹង	mɨŋ
មឹត	mɨt
មឹន	mɨn
មឹះ	mɨh
មឺត	mɨɨt
មុខ	mukʰ
មុង	muŋ
មុត	mut
មុន	mun
មុម	mum
មុយ	muj
មូង	muuŋ
មូរ	muu
មូល	muul
មូស	muuh
មួក	muək
មួន	muən
មួយ	muəj
មួរ	muə
មួល	muəl
មើក	məək
មើម	məəm
មើល	məəl
មឿង	mɨəŋ
មៀង	miəŋ
មៀន	miən
មៀម	miəm
មេន	meen
មែក	mɛɛk
មែន	mɛɛn
មោក	mook
មោង	mooŋ
មោះ	muəh
ម៉ក	mɑɑk
ម៉ប	mɑɑp
ម៉ែ	mae
ម៉ៃ	maj
ម៉ៅ	maw
យក់	juək
យង់	juŋ
យន់	jun
យប់	jup
យល់	jul
យាង	jieŋ
យាម	jiem
យាយ	jiej
យារ	jie
យាវ	jiew
យាស	jieh
យីះ	jih
យឹត	jɨt
យឺត	jɨɨt
យុក	juk
យុយ	juj
យុរ	ju
យុះ	juh
យូយ	juuj
យូរ	juu
យួន	juən
យួរ	juə
យើង	jəəŋ
យែក	jɛɛk
យោក	jook
យោង	jooŋ
យោល	jool
យ៉ស	jɑɑh
យ៉ើ	jaə
យ៉ៃ	jaj
រកម	rɔ\.kɑɑm
រកា	rɔ\.kaa
រខក	rɔ\.kʰɑɑk
រគង	rɔ\.kɔɔŋ
រងា	rɔ\.ŋie
រងូ	rɔ\.ŋuu
រងៃ	rɔ\.ŋej
រងំ	rɔ\.ŋum
រជយ	rɔ\.cɔɔj
រញម	rɔ\.ɲɔɔm
រញា	rɔ\.ɲie
រញី	rɔ\.ɲii
រញ៉	rɔɔɲ
រញ់	ruɲ
រដក	rɔ\.ɗɑɑk
រដែ	rɔ\.ɗae
រណប	rɔ\.nɑɑp
រត់	rut
រទង	rɔ\.tɔɔŋ
រទូ	rɔ\.tuu
រនង	rɔ\.nɔɔŋ
រនល	rɔ\.nɔɔl
រនះ	rɔ\.neah
របក	rɔ\.ɓɑɑk
របង	rɔ\.ɓɑɑŋ
របប	rɔ\.ɓɑɑp
របរ	rɔ\.ɓɑɑ
របៃ	rɔ\.ɓaj
របះ	rɔ\.ɓah
រយំ	rɔ\.jum
រយះ	rɔ\.jeah
រលក	rɔ\.lɔɔk
រលង	rɔ\.lɔɔŋ
រលម	rɔ\.lɔɔm
រលរ	rɔ\.lɔɔ
រលា	rɔ\.lie
រលី	rɔ\.lii
រលើ	rɔ\.ləə
រលឿ	rɔ\.lɨə
រលេ	rɔ\.lee
រលៃ	rɔ\.lej
រលំ	rɔ\.lum
រលះ	rɔ\.leah
រល់	rul
រវច	rɔ\.wɔɔc
រវម	rɔ\.wɔɔm
រវេ	rɔ\.wee
រវៃ	rɔ\.wej
រសក	rɔ\.sɑɑk
រសី	rɔ\.səj
រស់	ruəh
រហក	rɔ\.hɑɑk
រហប	rɔ\.hɑɑp
រហែ	rɔ\.hae
រឡូ	rɔ\.loo
រឡៅ	rɔ\.law
រអា	rɔ\.ʔaa
រអៃ	rɔ\.ʔaj
រាក	riek
រាង	rieŋ
រាច	riec
រាន	rien
រាប	riep
រាយ	riej
រាល	riel
រាវ	riew
រាំ	roam
រិញ	rɨɲ
រិម	rɨm
រិល	rɨl
រិះ	rih
រីក	riik
រីង	riiŋ
រីត	riit
រឹង	rɨŋ
រឹត	rɨt
រឹប	rɨp
រឹម	rɨm
រឹល	rɨl
រឹះ	rɨh
រឺត	rɨɨt
រុក	ruk
រុង	ruŋ
រុញ	ruɲ
រុត	rut
រុន	run
រុយ	ruj
រុល	rul
រុំ	rum
រុះ	ruh
រូង	ruuŋ
រូត	ruut
រូស	ruuh
រួច	ruəc
រួញ	ruəɲ
រួត	ruət
រួន	ruən
រួប	ruəp
រួម	ruəm
រួយ	ruəj
រួល	ruəl
រួស	ruəh
រើប	rəəp
រើម	rəəm
រើស	rəəh
រឿង	rɨəŋ
រឿយ	rɨəj
រៀង	riəŋ
រៀន	riən
រៀប	riəp
រៀម	riəm
រៀវ	riəw
រេច	reec
រេញ	reeɲ
រេល	reel
រេះ	reh
រែក	rɛɛk
រែង	rɛɛŋ
រែះ	rɛh
រោក	rook
រោង	rooŋ
រោច	rooc
រោម	room
រោយ	rooj
រោល	rool
រំហ	rum\.hɑɑ
រ៉ក	rɑɑk
រ៉ា	raa
រ៉ី	rəj
រ៉េ	ree
រ៉ែ	rae
រ៉ៃ	raj
លក់	luək
លង់	luŋ
លញ់	luɲ
លត់	lut
លន់	lun
លប់	lup
លលក	lɔ\.lɔɔk
លលេ	lɔ\.lee
លលៃ	lɔ\.lej
លស់	luəh
លាក	liek
លាង	lieŋ
លាញ	lieɲ
លាត	liet
លាន	lien
លាម	liem
លាយ	liej
លាវ	liew
លាស	lieh
លាំ	loam
លិច	lɨc
លិញ	lɨɲ
លីង	liiŋ
លីវ	liiw
លឹន	lɨn
លឹប	lɨp
លឹម	lɨm
លុក	luk
លុង	luŋ
លុត	lut
លុន	lun
លុយ	luj
លុះ	luh
លូក	luuk
លូច	luuc
លូត	luut
លូន	luun
លួង	luəŋ
លួច	luəc
លួត	luət
លួស	luəh
លើក	ləək
លើង	ləəŋ
លើស	ləəh
លឿង	lɨəŋ
លឿន	lɨən
លឿម	lɨəm
លឿយ	lɨəj
លៀង	liəŋ
លៀត	liət
លៀន	liən
លៀប	liəp
លៀម	liəm
លៀវ	liəw
លៀស	liəh
លេង	leeŋ
លេច	leec
លេញ	leeɲ
លេប	leep
លេះ	leh
លែង	lɛɛŋ
លោង	looŋ
លោត	loot
លោម	loom
លោះ	luəh
លំហ	lum\.hɑɑ
លំអ	lum\.ʔɑɑ
ល្ង	lŋɔɔ
ល្ហ	lhɑɑ
ល្អ	lʔɑɑ
វក់	wuək
វង់	wuŋ
វាង	wieŋ
វាច	wiec
វាយ	wiej
វារ	wie
វាល	wiel
វាវ	wiew
វាស	wieh
វិច	wɨc
វិញ	wɨɲ
វិល	wɨl
វិះ	wih
វឹក	wɨk
វឹង	wɨŋ
វឹត	wɨt
វឹប	wɨp
វឹល	wɨl
វឹះ	wɨh
វឺប	wɨɨp
វុន	wun
វូប	wuup
វូម	wuum
វើក	wəək
វើត	wəət
វើម	wəəm
វៀង	wiəŋ
វៀច	wiəc
វៀន	wiən
វៀរ	wiə
វៀល	wiəl
វៀះ	wiəh
វេច	weec
វេញ	weeɲ
វេរ	wee
វេះ	weh
វែក	wɛɛk
វែង	wɛɛŋ
វោត	woot
វ៉ក	wɑɑk
វ៉ប	wɑɑp
វ៉ស	wɑɑh
វ៉ា	waa
វ៉ី	wəj
វ៉ូ	woo
វ៉េ	wee
វ៉ៃ	waj
វ៉ៅ	waw
សក់	sɑk
សង់	sɑŋ
សប់	sɑp
សល់	sɑl
សសរ	sɑ\.sɑɑ
សាក	saak
សាង	saaŋ
សាច	saac
សាញ	saaɲ
សាន	saan
សាប	saap
សាយ	saaj
សាវ	saaw
សាំ	sam
សិញ	səɲ
សិន	sən
សឹក	sək
សឹង	səŋ
សឹម	səm
សុក	sok
សុង	soŋ
សុច	soc
សុល	sol
សុស	soh
សុំ	som
សូន	soon
សូម	soom
សូវ	soow
សួង	suəŋ
សួត	suət
សួន	suən
សួយ	suəj
សួរ	suə
សើក	saək
សើច	saəc
សើន	saən
សើម	saəm
សើយ	saəj
សឿង	sɨəŋ
សៀង	siəŋ
សៀត	siət
សៀន	siən
សៀម	siəm
សៀរ	siə
សៀវ	siəw
សេក	seek
សេង	seeŋ
សេញ	seeɲ
សេន	seen
សេវ	seew
សេះ	seh
សែក	saek
សែង	saeŋ
សែត	saet
សែន	saen
សោត	saot
សោយ	saoj
សោះ	sɑh
សំណ	sɑm\.nɑɑ
ស៊ក	sɔɔk
ស៊ង	sɔɔŋ
ស៊ន	sɔɔn
ស៊យ	sɔɔj
ស៊ី	sii
ស៊ូ	suu
ស៊ែ	sɛɛ
ស្ដ	sɗɑɑ
ស្ន	snɑɑ
ស្ម	smɑɑ
ស្រ	srɑɑ
ស្ល	slɑɑ
ហក់	hɑk
ហត់	hɑt
ហប់	hɑp
ហាង	haaŋ
ហាន	haan
ហាប	haap
ហាម	haam
ហាល	haal
ហាវ	haaw
ហិច	həc
ហិញ	həɲ
ហិប	həp
ហិល	həl
ហឹប	həp
ហឹរ	hə
ហឺត	həət
ហឺប	həəp
ហឺយ	həəj
ហុង	hoŋ
ហុច	hoc
ហុត	hot
ហុយ	hoj
ហុរ	ho
ហូត	hoot
ហូប	hoop
ហូរ	hoo
ហូល	hool
ហួង	huəŋ
ហួច	huəc
ហួញ	huəɲ
ហួត	huət
ហួម	huəm
ហួយ	huəj
ហួរ	huə
ហួល	huəl
ហួស	huəh
ហើប	haəp
ហើម	haəm
ហើយ	haəj
ហើរ	haə
ហៀន	hiən
ហៀរ	hiə
ហៀវ	hiəw
ហេង	heeŋ
ហេញ	heeɲ
ហេប	heep
ហេវ	heew
ហេះ	heh
ហែក	haek
ហែង	haeŋ
ហែប	haep
ហែះ	haeh
ហោក	haok
ហោង	haoŋ
ហោច	haoc
ហោល	haol
ហោះ	hɑh
ហ៊ប	hɔɔp
ហ៊ស	hɔɔh
ហ៊ិ	hiʔ
ហ៊ី	hii
ហ៊ឹ	hɨʔ
ហ៊ឺ	hɨɨ
ហ៊ូ	huu
ហ៊ែ	hɛɛ
ហ៊ោ	hoo
ហ៊ៅ	hɨw
ហ្ន	hnɑɑ
ហ្ម	hmɑɑ
ឡង់	lɑŋ
ឡប់	lɑp
ឡាក	laak
ឡាន	laan
ឡាប	laap
ឡាយ	laaj
ឡាវ	laaw
ឡាំ	lam
ឡិច	ləc
ឡិន	lən
ឡឹប	ləp
ឡឹម	ləm
ឡឺត	ləət
ឡឺម	ləəm
ឡុប	lop
ឡុល	lol
ឡូង	looŋ
ឡូញ	looɲ
ឡូយ	looj
ឡើង	laəŋ
ឡើយ	laəj
ឡេវ	leew
ឡែក	laek
ឡែម	laem
ឡែឡ	lael
ឡោក	laok
ឡោម	laom
អង់	ʔɑŋ
អត់	ʔɑt
អន់	ʔɑn
អប់	ʔɑp
អស់	ʔɑh
អាង	ʔaaŋ
អាច	ʔaac
អាន	ʔaan
អាប	ʔaap
អាម	ʔaam
អាយ	ʔaaj
អារ	ʔaa
អាល	ʔaal
អាវ	ʔaaw
អាស	ʔaah
អាំ	ʔam
អាះ	ʔaah
អឹង	ʔəŋ
អឺត	ʔəət
អឺយ	ʔəəj
អឺះ	ʔəəh
អុង	ʔoŋ
អុច	ʔoc
អុញ	ʔoɲ
អុត	ʔot
អុរ	ʔo
អុល	ʔol
អុំ	ʔom
អុះ	ʔoh
អូច	ʔooc
អូត	ʔoot
អូន	ʔoon
អូយ	ʔooj
អូរ	ʔoo
អូស	ʔooh
អូះ	ʔooh
អួត	ʔuət
អួន	ʔuən
អួល	ʔuəl
អួស	ʔuəh
អើត	ʔaət
អើយ	ʔaəj
អៀង	ʔiəŋ
អៀន	ʔiən
អៀម	ʔiəm
អៀវ	ʔiəw
អេក	ʔeek
អេប	ʔeep
អេះ	ʔeh
អែប	ʔaep
អែម	ʔaem
អ៊ី	ʔii
អ៊ូ	ʔuu
អ៊ំ	ʔum
អ្ហ	ʔhɑɑ
កកាត	kɑ\.kaat
កកាយ	kɑ\.kaaj
កកិត	kɑ\.kət
កកិល	kɑ\.kəl
កកូរ	kɑ\.koo
កកេរ	kɑ\.kee
កកេះ	kɑ\.keh
កកែប	kɑ\.kaep
កកោក	kɑ\.kaok
កកោស	kɑ\.kaoh
កកោះ	kɑ\.kɑh
កខឹក	kɑ\.kʰək
កខុប	kɑ\.kʰop
កឋិន	kɑ\.tʰən
កម្រ	kɑm\.rɑɑ
កសាង	kɑ\.saaŋ
កាក់	kak
កាច់	kac
កាញ់	kaɲ
កាន់	kan
កាល់	kal
កំញម	kɑm\.ɲɑɑm
កំដរ	kɑm\.ɗɑɑ
កំណក	kɑm\.nɑɑk
កំណែ	kɑm\.nae
កំពក	kɑm\.pɔɔk
កំពត	kɑm\.pɔɔt
កំពយ	kɑm\.pɔɔj
កំភរ	kɑm\.pʰɔɔ
កំហក	kɑm\.hɑɑk
ក្ដី	kɗəj
ក្ដៅ	kɗaw
ក្បក	kɓɑɑk
ក្បំ	kɓɑm
ក្រក	krɑɑk
ក្រង	krɑɑŋ
ក្រត	krɑɑt
ក្រប	krɑɑp
ក្រឡ	krɑɑl
ក្រា	kraa
ក្រី	krəj
ក្រៃ	kraj
ក្រៅ	kraw
ក្រំ	krɑm
ក្លង	klɑɑŋ
ក្លន	klɑɑn
ក្លម	klɑɑm
ក្លា	klaa
ក្លើ	klaə
ក្លំ	klɑm
ក្អក	kʔɑɑk
ក្អម	kʔɑɑm
ក្អី	kʔəj
ក្អែ	kʔae
ខខិត	kʰɑ\.kʰət
ខាត់	kʰat
ខាន់	kʰan
ខាប់	kʰap
ខាល់	kʰal
ខាំង	kʰaŋ
ខ្ចក	kcɑɑk
ខ្ចរ	kcɑɑ
ខ្ចី	kcəj
ខ្ចៅ	kcaw
ខ្ញក	kɲɑɑk
ខ្ញម	kɲɑɑm
ខ្ញី	kɲəj
ខ្តត	ktɑɑt
ខ្ទប	ktɔɔp
ខ្ទម	ktɔɔm
ខ្ទរ	ktɔɔ
ខ្ទះ	kteah
ខ្នង	knɑɑŋ
ខ្នៅ	knaw
ខ្ពប	kpɔɔp
ខ្មង	kmɑɑŋ
ខ្មី	kməj
ខ្មៅ	kmaw
ខ្យង	kjɑɑŋ
ខ្លប	klɑɑp
ខ្លា	klaa
ខ្លី	kləj
ខ្លះ	klah
ខ្វក	kwɑɑk
ខ្វង	kwɑɑŋ
ខ្វែ	kwae
ខ្វះ	kwah
ខ្សត	ksɑɑt
ខ្សៀ	ksiə
ខ្សែ	ksae
គគាច	kɔ\.kiec
គគាត	kɔ\.kiet
គគីរ	kɔ\.kii
គគឹក	kɔ\.kɨk
គគឹត	kɔ\.kɨt
គគុក	kɔ\.kuk
គគុល	kɔ\.kul
គគុះ	kɔ\.kuh
គគើម	kɔ\.kəəm
គឃារ	kɔ\.kʰie
គឃឹក	kɔ\.kʰɨk
គឃុល	kɔ\.kʰul
គឃូស	kɔ\.kʰuuh
គឃៀរ	kɔ\.kʰiə
គនប់	kɔ\.nup
គាក់	keak
គាត់	koat
គាប់	koap
គាល់	koal
គាស់	koah
គាំង	keaŋ
គំនង	kum\.nɔɔŋ
គំនម	kum\.nɔɔm
គំនរ	kum\.nɔɔ
គំរល	kum\.rɔɔl
គំរូ	kum\.ruu
គំហក	kum\.hɑɑk
គ្នា	knie
គ្នី	knii
គ្រក	krɔɔk
គ្រង	krɔɔŋ
គ្រប	krɔɔp
គ្រា	krie
គ្រួ	kruə
គ្រែ	krɛɛ
គ្រំ	krum
ឃាំង	kʰeaŋ
ឃ្នង	knɔɔŋ
ឃ្មម	kmɔɔm
ឃ្លា	klie
ឃ្លេ	klee
ឃ្លៃ	klej
ងងក់	ŋɔ\.ŋuək
ងងល់	ŋɔ\.ŋul
ងងាស	ŋɔ\.ŋieh
ងងឹត	ŋɔ\.ŋɨt
ងងុយ	ŋɔ\.ŋuj
ងងុល	ŋɔ\.ŋul
ងងុះ	ŋɔ\.ŋuh
ងងូស	ŋɔ\.ŋuuh
ងងើល	ŋɔ\.ŋəəl
ងាប់	ŋoap
ងាស់	ŋoah
ងាំង	ŋeaŋ
ង៉ក់	ŋɑk
ង៉ាង	ŋaaŋ
ង៉ាវ	ŋaaw
ង៉ាំ	ŋam
ង៉ឹក	ŋək
ង៉ឺត	ŋəət
ង៉ឺស	ŋəəh
ង៉ុម	ŋom
ង៉ុល	ŋol
ង៉ូង	ŋooŋ
ង៉ូត	ŋoot
ង៉ូវ	ŋoow
ង៉េក	ŋeek
ង៉េត	ŋeet
ង៉េវ	ŋeew
ង៉េស	ŋeeh
ង៉េះ	ŋeh
ង៉ែត	ŋaet
ង៉ោង	ŋaoŋ
ង៉ោះ	ŋɑh
ចចក់	cɑ\.cɑk
ចចាត	cɑ\.caat
ចចឹក	cɑ\.cək
ចចូត	cɑ\.coot
ចចើង	cɑ\.caəŋ
ចចេស	cɑ\.ceeh
ចាក់	cak
ចាច់	cac
ចាញ់	caɲ
ចាត់	cat
ចាប់	cap
ចាល់	cal
ចាស់	cah
ចាំង	caŋ
ចំណង	cɑm\.nɑɑŋ
ចំណត	cɑm\.nɑɑt
ចំណរ	cɑm\.nɑɑ
ចំណី	cɑm\.nəj
ចំណំ	cɑm\.nɑm
ចំទយ	cɑm\.tɔɔj
ចំឡក	cɑm\.lɑɑk
ចំអក	cɑm\.ʔɑɑk
ចំអែ	cɑm\.ʔae
ច្នៃ	cnaj
ច្បង	cɓɑɑŋ
ច្រក	crɑɑk
ច្រច	crɑɑc
ច្រម	crɑɑm
ច្រស	crɑɑh
ច្រហ	crɑɑh
ច្រំ	crɑm
ឆាន់	cʰan
ឆាប់	cʰap
ឆាល់	cʰal
ឆាំង	cʰaŋ
ឆ្កយ	ckɑɑj
ឆ្កែ	ckae
ឆ្គង	ckɔɔŋ
ឆ្ងក	cŋɑɑk
ឆ្ងែ	cŋae
ឆ្ដោ	cɗao
ឆ្នៃ	cnaj
ឆ្មប	cmɑɑp
ឆ្មា	cmaa
ឆ្មៃ	cmaj
ឆ្លក	clɑɑk
ឆ្លង	clɑɑŋ
ឆ្លា	claa
ឆ្លេ	clee
ឆ្លៅ	claw
ឆ្វា	cwaa
ឆ្អៅ	cʔaw
ជជីក	cɔ\.ciik
ជជុះ	cɔ\.cuh
ជជួរ	cɔ\.cuə
ជជើល	cɔ\.cəəl
ជជែក	cɔ\.cɛɛk
ជន្ល	cun\.lɔɔ
ជាក់	ceak
ជាត់	coat
ជាន់	coan
ជាប់	coap
ជំងឺ	cum\.ŋɨɨ
ជំទយ	cum\.tɔɔj
ជំនា	cum\.nie
ជំនឿ	cum\.nɨə
ជំនំ	cum\.num
ជំរំ	cum\.rum
ជំហម	cum\.hɑɑm
ជំហរ	cum\.hɑɑ
ជំហៅ	cum\.haw
ជ្រក	crɔɔk
ជ្រង	crɔɔŋ
ជ្រប	crɔɔp
ជ្រេ	cree
ជ្រែ	crɛɛ
ជ្រៃ	crej
ជ្រោ	croo
ជ្រៅ	crɨw
ជ្រំ	crum
ជ្រះ	creah
ជ្វា	cwie
ឈ្នះ	cneah
ឈ្មង	cmɔɔŋ
ឈ្មែ	cmɛɛ
ឈ្លប	clɔɔp
ឈ្លម	clɔɔm
ឈ្លី	clii
ញញិម	ɲɔ\.ɲɨm
ញញួរ	ɲɔ\.ɲuə
ញញើត	ɲɔ\.ɲəət
ញញើម	ɲɔ\.ɲəəm
ញញែម	ɲɔ\.ɲɛɛm
ញញោច	ɲɔ\.ɲooc
ញាក់	ɲeak
ញាត់	ɲoat
ញាប់	ɲoap
ញាស់	ɲoah
ញ៉ាក	ɲaak
ញ៉ាប	ɲaap
ញ៉ាម	ɲaam
ញ៉ាំ	ɲam
ញ៉ិម	ɲəm
ញ៉ិល	ɲəl
ញ៉ឹង	ɲəŋ
ញ៉ឹម	ɲəm
ញ៉ុញ	ɲoɲ
ញ៉ុម	ɲom
ញ៉ើក	ɲaək
ញ៉េប	ɲeep
ញ៉េវ	ɲeew
ញ៉ែង	ɲaeŋ
ញ៉ែម	ɲaem
ញ៉ោង	ɲaoŋ
ដដុស	ɗɑ\.ɗoh
ដដែល	ɗɑ\.ɗael
ដរាប	ɗɑ\.raap
ដលោក	ɗɑ\.laok
ដាក់	ɗak
ដាច់	ɗac
ដាប់	ɗap
ដាល់	ɗal
ដាស់	ɗah
ដាំង	ɗaŋ
ដោះញ	ɗɑhɲ
ដំណក	ɗɑm\.nɑɑk
ដំណង	ɗɑm\.nɑɑŋ
ដំណៅ	ɗɑm\.naw
ដំណំ	ɗɑm\.nɑm
ដំបង	ɗɑm\.ɓɑɑŋ
ដំបែ	ɗɑm\.ɓae
ដំបៅ	ɗɑm\.ɓaw
ដំរី	ɗɑm\.rəj
ណាត់	nat
ណាស់	nah
ណាំង	naŋ
តតូង	tɑ\.tooŋ
តវ៉ា	tɑ\.waa
តាន់	tan
តាប់	tap
តាំង	taŋ
តំនឿ	tɑm\.nɨə
ត្បក	tɓɑɑk
ត្បទ	tɓɑɑt
ត្មះ	tmah
ត្រក	trɑɑk
ត្រង	trɑɑŋ
ត្រត	trɑɑt
ត្រា	traa
ត្រី	trəj
ត្រែ	trae
ត្លែ	tlae
ត្វា	twaa
ត្អួ	tʔuə
ថាប់	tʰap
ថាំង	tʰaŋ
ថ្ករ	tkɑɑ
ថ្កំ	tkɑm
ថ្ងប	tŋɑɑp
ថ្ងៃ	tŋaj
ថ្នង	tnɑɑŋ
ថ្នម	tnɑɑm
ថ្នរ	tnɑɑ
ថ្នះ	tnah
ថ្ពង	tpɔɔŋ
ថ្ពៅ	tpɨw
ថ្មី	tməj
ថ្មែ	tmae
ថ្លា	tlaa
ថ្លៃ	tlaj
ថ្វី	twəj
ថ្វែ	twae
ទទត់	tɔ\.tut
ទទារ	tɔ\.tie
ទទឹក	tɔ\.tɨk
ទទឹង	tɔ\.tɨŋ
ទទុង	tɔ\.tuŋ
ទទូច	tɔ\.tuuc
ទទូរ	tɔ\.tuu
ទទួល	tɔ\.tuəl
ទទើម	tɔ\.təəm
ទទោក	tɔ\.took
ទម្រ	tum\.rɔɔ
ទឡ្ហ	tɔ\.lhɑɑ
ទាក់	teak
ទាត់	toat
ទាន់	toan
ទាល់	toal
ទាស់	toah
ទាំង	teaŋ
ទំនង	tum\.nɔɔŋ
ទំពា	tum\.pie
ទំយើ	tum\.jəə
ទំហំ	tum\.hɑm
ទ្រត	trɔɔt
ទ្រប	trɔɔp
ទ្រម	trɔɔm
ទ្រូ	truu
ធាត់	tʰoat
ធ្នូ	tnuu
ធ្នះ	tneah
ធ្មា	tmie
ធ្មៃ	tmej
ធ្មៅ	tmɨw
ធ្លក	tlɔɔk
ធ្លា	tlie
ធ្លូ	tluu
ធ្លោ	tloo
ធ្លះ	tleah
ធ្វើ	twəə
ននៀល	nɔ\.niəl
ននោង	nɔ\.nooŋ
នាក់	neak
បក្ស	ɓɑ\.ksɑɑ
បង្ក	ɓɑŋ\.kɑɑ
បធាន	ɓɑ\.tʰien
បន្ត	ɓɑn\.tɑɑ
បបក់	ɓɑ\.ɓɑk
បបុស	ɓɑ\.ɓoh
បបូរ	ɓɑ\.ɓoo
បបួល	ɓɑ\.ɓuəl
បបែល	ɓɑ\.ɓael
បបោស	ɓɑ\.ɓaoh
បសាទ	ɓɑ\.saat
បាក់	ɓak
បាច់	ɓac
បាញ់	ɓaɲ
បាត់	ɓat
បាល់	ɓal
បាំង	ɓaŋ
បំណង	ɓɑm\.nɑɑŋ
បំណែ	ɓɑm\.nae
បំណះ	ɓɑm\.nah
បំបប	ɓɑm\.ɓɑɑp
បំបរ	ɓɑm\.ɓɑɑ
បំបៅ	ɓɑm\.ɓaw
បំបះ	ɓɑm\.ɓah
បំផត	ɓɑm\.pʰɑɑt
បំពង	ɓɑm\.pɔɔŋ
បំពម	ɓɑm\.pɔɔm
បំពេ	ɓɑm\.pee
បំភល	ɓɑm\.pʰɔɔl
ប៉ក់	pɑk
ប៉ន់	pɑn
ប៉ប់	pɑp
ប៉ផស	pɑ\.pʰɑɑh
ប៉ពូ	pɑ\.puu
ប៉ាត	paat
ប៉ាន	paan
ប៉ាយ	paaj
ប៉ាវ	paaw
ប៉ិក	pək
ប៉ិច	pəc
ប៉ិត	pət
ប៉ិន	pən
ប៉ិល	pəl
ប៉ឹង	pəŋ
ប៉ឹម	pəm
ប៉ឺង	pəəŋ
ប៉ឺន	pəən
ប៉ឺប	pəəp
ប៉ឺម	pəəm
ប៉ុក	pok
ប៉ុង	poŋ
ប៉ុន	pon
ប៉ុប	pop
ប៉ុយ	poj
ប៉ូក	pook
ប៉ូង	pooŋ
ប៉ូច	pooc
ប៉ូវ	poow
ប៉ើក	paək
ប៉ើង	paəŋ
ប៉ើច	paəc
ប៉ើម	paəm
ប៉េង	peeŋ
ប៉េវ	peew
ប៉ែក	paek
ប៉ែង	paeŋ
ប៉ែន	paen
ប៉ែល	pael
ប៉ែវ	paew
ប៉ែះ	paeh
ប៉ោក	paok
ប៉ោង	paoŋ
ប៉ោច	paoc
ប៉ោត	paot
ប៉ោម	paom
ប៉ោយ	paoj
ប៉ោល	paol
ប៊ិក	ɓɨk
ប៊ិះ	ɓih
ប៊ុត	ɓut
ប្រច	prɑɑc
ប្រប	prɑɑp
ប្រព	prɑɑp
ប្រស	prɑɑh
ប្រា	praa
ប្រី	prəj
ប្រើ	praə
ប្រែ	prae
ប្រៃ	praj
ប្រះ	prah
ប្លត	plɑɑt
ប្លម	plɑɑm
ផាត់	pʰat
ផាប់	pʰap
ផាំង	pʰaŋ
ផ្កា	pkaa
ផ្គង	pkɔɔŋ
ផ្គរ	pkɔɔ
ផ្គូ	pkuu
ផ្ងំ	pŋɑm
ផ្ញើ	pɲaə
ផ្ដែ	pɗae
ផ្ដៅ	pɗaw
ផ្ទា	ptie
ផ្ទី	ptii
ផ្ទឺ	ptɨɨ
ផ្ទៃ	ptej
ផ្ទំ	ptum
ផ្ទះ	pteah
ផ្លែ	plae
ផ្សង	psɑɑŋ
ផ្សា	psaa
ផ្សែ	psae
ផ្សៃ	psaj
ផ្សោ	psao
ផ្សំ	psɑm
ផ្សះ	psah
ផ្អក	pʔɑɑk
ផ្អង	pʔɑɑŋ
ផ្អប	pʔɑɑp
ផ្អរ	pʔɑɑ
ពង្រ	puŋ\.rɔɔ
ពន្ទ	pun\.tɔɔ
ពពាច	pɔ\.piec
ពពាន	pɔ\.pien
ពពារ	pɔ\.pie
ពពាល	pɔ\.piel
ពពិច	pɔ\.pɨc
ពពិល	pɔ\.pɨl
ពពីម	pɔ\.piim
ពពីរ	pɔ\.pii
ពពឹក	pɔ\.pɨk
ពពុរ	pɔ\.pu
ពពុះ	pɔ\.puh
ពពូក	pɔ\.puuk
ពពូន	pɔ\.puun
ពពូល	pɔ\.puul
ពពួក	pɔ\.puək
ពពើម	pɔ\.pəəm
ពពេច	pɔ\.peec
ពពេន	pɔ\.peen
ពពេល	pɔ\.peel
ពពោក	pɔ\.pook
ពភក់	pɔ\.pʰuək
ពភីង	pɔ\.pʰiiŋ
ពភឹប	pɔ\.pʰɨp
ពភឹល	pɔ\.pʰɨl
ពភឺត	pɔ\.pʰɨɨt
ពភឺស	pɔ\.pʰɨɨh
ពភុង	pɔ\.pʰuŋ
ពភូស	pɔ\.pʰuuh
ពាក់	peak
ពាន់	poan
ពាប់	poap
ពាល់	poal
ពាំង	peaŋ
ព្នង	pnɔɔŋ
ព្នៃ	pnej
ព្នៅ	pnɨw
ព្រក	prɔɔk
ព្រត	prɔɔt
ព្រម	prɔɔm
ព្រយ	prɔɔj
ព្រល	prɔɔl
ព្រា	prie
ព្រឺ	prɨɨ
ព្រូ	pruu
ព្រែ	prɛɛ
ព្រៃ	prej
ព្រៅ	prɨw
ព្រំ	prum
ភាំង	pʰeaŋ
ភ្ងា	pŋie
ភ្ងំ	pŋum
ភ្ជរ	pcɔɔ
ភ្ញី	pɲii
ភ្នក	pnɔɔk
ភ្នំ	pnum
ភ្លង	plɔɔŋ
ភ្លន	plɔɔn
ភ្លយ	plɔɔj
ភ្លា	plie
ភ្លឺ	plɨɨ
ភ្លូ	pluu
ភ្លើ	pləə
ភ្លៅ	plɨw
មមង់	mɔ\.muŋ
មមាច	mɔ\.miec
មមាញ	mɔ\.mieɲ
មមាយ	mɔ\.miej
មមាល	mɔ\.miel
មមីស	mɔ\.miih
មមឹះ	mɔ\.mɨh
មមុល	mɔ\.mul
មមើក	mɔ\.məək
មមៀរ	mɔ\.miə
មមោក	mɔ\.mook
មហាត	mɔ\.haat
មាត់	moat
មាន់	moan
មំសំ	mum\.sɑm
ម៉ក់	mɑk
ម៉ង់	mɑŋ
ម៉ឆែ	mɑ\.cʰae
ម៉ត់	mɑt
ម៉ាង	maaŋ
ម៉ាំ	mam
ម៉ិម	məm
ម៉ឹង	məŋ
ម៉ឹប	məp
ម៉ឹម	məm
ម៉ឺង	məəŋ
ម៉ុង	moŋ
ម៉ុម	mom
ម៉ូក	mook
ម៉ូង	mooŋ
ម៉ូត	moot
ម៉េច	meec
ម៉ោង	maoŋ
ម្ដង	mɗɑɑŋ
ម្ដា	mɗaa
ម្នា	mnie
ម្នៅ	mnɨw
ម្នះ	mneah
ម្ភៃ	mpʰej
ម្រយ	mrɔɔj
ម្រះ	mreah
ម្លូ	mluu
ម្សៅ	msaw
ម្ហប	mhɑɑp
ម្ហា	mhaa
ម្អម	mʔɑɑm
យាំង	jeaŋ
យ៉ាក	jaak
យ៉ាង	jaaŋ
យ៉ាវ	jaaw
យ៉ឺរ	jəə
យ៉ូយ	jooj
យ៉ើរ	jaə
យ៉ើះ	jaəh
រកាំ	rɔ\.kam
រកឹក	rɔ\.kək
រកឹង	rɔ\.kəŋ
រកូត	rɔ\.koot
រកៀស	rɔ\.kiəh
រកេត	rɔ\.keet
រខក់	rɔ\.kʰɑk
រខាក	rɔ\.kʰaak
រខិញ	rɔ\.kʰəɲ
រខិត	rɔ\.kʰət
រខិន	rɔ\.kʰən
រខឺត	rɔ\.kʰəət
រខុញ	rɔ\.kʰoɲ
រខូស	rɔ\.kʰooh
រខេក	rɔ\.kʰeek
រខែក	rɔ\.kʰaek
រខែះ	rɔ\.kʰaeh
រខោក	rɔ\.kʰaok
រគាម	rɔ\.kiem
រគីង	rɔ\.kiiŋ
រគីម	rɔ\.kiim
រគឹង	rɔ\.kɨŋ
រគុប	rɔ\.kup
រគើម	rɔ\.kəəm
រគើល	rɔ\.kəəl
រគេង	rɔ\.keeŋ
រគេន	rɔ\.keen
រគោង	rɔ\.kooŋ
រគោល	rɔ\.kool
រឃុង	rɔ\.kʰuŋ
រងល់	rɔ\.ŋul
រងាល	rɔ\.ŋiel
រងាវ	rɔ\.ŋiew
រងីក	rɔ\.ŋiik
រងុម	rɔ\.ŋum
រងុំ	rɔ\.ŋum
រងួយ	rɔ\.ŋuəj
រងើក	rɔ\.ŋəək
រងើម	rɔ\.ŋəəm
រងៀក	rɔ\.ŋiək
រងៀម	rɔ\.ŋiəm
រងែក	rɔ\.ŋɛɛk
រងោក	rɔ\.ŋook
រង៉ែ	rɔ\.ŋae
រជើប	rɔ\.cəəp
រជោរ	rɔ\.coo
រញង់	rɔ\.ɲuŋ
រញីវ	rɔ\.ɲiiw
រញឹក	rɔ\.ɲɨk
រញៀវ	rɔ\.ɲiəw
រញេញ	rɔ\.ɲeeɲ
រញ៉ី	rɔ\.ɲəj
រញ៉ែ	rɔ\.ɲae
រដិប	rɔ\.ɗəp
រដឹក	rɔ\.ɗək
រដឺន	rɔ\.ɗəən
រដុប	rɔ\.ɗop
រដូក	rɔ\.ɗook
រដៀន	rɔ\.ɗiən
រដេច	rɔ\.ɗeec
រដែត	rɔ\.ɗaet
រដោះ	rɔ\.ɗɑh
រឌុក	rɔ\.ɗuk
រណារ	rɔ\.naa
រណិល	rɔ\.nəl
រណែង	rɔ\.naeŋ
រណែល	rɔ\.nael
រណោង	rɔ\.naoŋ
រតាក	rɔ\.taak
រតាយ	rɔ\.taaj
រតាវ	rɔ\.taaw
រតឹង	rɔ\.təŋ
រតូត	rɔ\.toot
រតេក	rɔ\.teek
រតេត	rɔ\.teet
រតេយ	rɔ\.teej
រតេវ	rɔ\.teew
រតែក	rɔ\.taek
រតែង	rɔ\.taeŋ
រតោក	rɔ\.taok
រតោង	rɔ\.taoŋ
រទាស	rɔ\.tieh
រទាំ	rɔ\.toam
រទីស	rɔ\.tiih
រទុះ	rɔ\.tuh
រទើស	rɔ\.təəh
រទេញ	rɔ\.teeɲ
រទេះ	rɔ\.teh
រទែង	rɔ\.tɛɛŋ
រទោង	rɔ\.tooŋ
រនាត	rɔ\.niet
រនាប	rɔ\.niep
រនាម	rɔ\.niem
រនាល	rɔ\.niel
រនុក	rɔ\.nuk
រនូត	rɔ\.nuut
រនួត	rɔ\.nuət
រនេល	rɔ\.neel
រនោង	rɔ\.nooŋ
រនោច	rɔ\.nooc
រនោល	rɔ\.nool
រន្ធ	run\.tʰɔɔ
របត់	rɔ\.ɓɑt
របស់	rɔ\.ɓɑh
របាញ	rɔ\.ɓaaɲ
របាទ	rɔ\.ɓaat
របាយ	rɔ\.ɓaaj
របារ	rɔ\.ɓaa
របាល	rɔ\.ɓaal
របាំ	rɔ\.ɓam
របឹង	rɔ\.ɓəŋ
របឹប	rɔ\.ɓəp
របុក	rɔ\.ɓok
របុង	rɔ\.ɓoŋ
របុញ	rɔ\.ɓoɲ
របុម	rɔ\.ɓom
របុំ	rɔ\.ɓom
របូត	rɔ\.ɓoot
របួល	rɔ\.ɓuəl
របួស	rɔ\.ɓuəh
របើក	rɔ\.ɓaək
របើរ	rɔ\.ɓaə
របើស	rɔ\.ɓaəh
របៀង	rɔ\.ɓiəŋ
របៀន	rɔ\.ɓiən
របៀប	rɔ\.ɓiəp
របេង	rɔ\.ɓeeŋ
របេះ	rɔ\.ɓeh
របែង	rɔ\.ɓaeŋ
របោច	rɔ\.ɓaoc
របោម	rɔ\.ɓaom
របោយ	rɔ\.ɓaoj
របោះ	rɔ\.ɓɑh
រពាយ	rɔ\.piej
រពីង	rɔ\.piiŋ
រពឹក	rɔ\.pɨk
រពឹល	rɔ\.pɨl
រពឹស	rɔ\.pɨh
រពុក	rɔ\.puk
រពុយ	rɔ\.puj
រពោង	rɔ\.pooŋ
រមត់	rɔ\.mut
រមាក	rɔ\.miek
រមាស	rɔ\.mieh
រមិល	rɔ\.mɨl
រមឹល	rɔ\.mɨl
រមូរ	rɔ\.muu
រមូល	rɔ\.muul
រមួល	rɔ\.muəl
រមៀត	rɔ\.miət
រមៀល	rɔ\.miəl
រមេញ	rɔ\.meeɲ
រមែង	rɔ\.mɛɛŋ
រម្ហ	rum\.hɑɑ
រយាក	rɔ\.jiek
រយាង	rɔ\.jieŋ
រយាន	rɔ\.jien
រយាប	rɔ\.jiep
រយាយ	rɔ\.jiej
រយាល	rɔ\.jiel
រយីក	rɔ\.jiik
រយីង	rɔ\.jiiŋ
រយឺត	rɔ\.jɨɨt
រយេង	rɔ\.jeeŋ
រយោង	rɔ\.jooŋ
រយោន	rɔ\.joon
រយ៉ី	rɔ\.jəj
រយ៉ៃ	rɔ\.jaj
រលង់	rɔ\.luŋ
រលត់	rɔ\.lut
រលប់	rɔ\.lup
រលស់	rɔ\.luəh
រលាក	rɔ\.liek
រលាត	rɔ\.liet
រលាប	rɔ\.liep
រលាម	rɔ\.liem
រលាយ	rɔ\.liej
រលាំ	rɔ\.loam
រលិស	rɔ\.lih
រលីក	rɔ\.liik
រលីង	rɔ\.liiŋ
រលីវ	rɔ\.liiw
រលឹក	rɔ\.lɨk
រលឹម	rɔ\.lɨm
រលុង	rɔ\.luŋ
រលុះ	rɔ\.luh
រលូង	rɔ\.luuŋ
រលូត	rɔ\.luut
រលូន	rɔ\.luun
រលួត	rɔ\.luət
រលួយ	rɔ\.luəj
រលួស	rɔ\.luəh
រលើង	rɔ\.ləəŋ
រលើប	rɔ\.ləəp
រលៀក	rɔ\.liək
រលៀង	rɔ\.liəŋ
រលេញ	rɔ\.leeɲ
រលេះ	rɔ\.leh
រលែក	rɔ\.lɛɛk
រលែម	rɔ\.lɛɛm
រលែះ	rɔ\.lɛh
រលោក	rɔ\.look
រលោង	rɔ\.looŋ
រលោច	rɔ\.looc
រវល់	rɔ\.wul
រវាង	rɔ\.wieŋ
រវាត	rɔ\.wiet
រវាន	rɔ\.wien
រវាម	rɔ\.wiem
រវិន	rɔ\.wɨn
រវីក	rɔ\.wiik
រវីម	rɔ\.wiim
រវីស	rɔ\.wiih
រវូប	rɔ\.wuup
រវើក	rɔ\.wəək
រវើម	rɔ\.wəəm
រវៀស	rɔ\.wiəh
រវែង	rɔ\.wɛɛŋ
រសាក	rɔ\.saak
រសាច	rɔ\.saac
រសាយ	rɔ\.saaj
រសាវ	rɔ\.saaw
រសឹប	rɔ\.səp
រសុក	rɔ\.sok
រសុល	rɔ\.sol
រសុស	rɔ\.soh
រសូវ	rɔ\.soow
រសើប	rɔ\.saəp
រសៀល	rɔ\.siəl
រសេច	rɔ\.seec
រសេវ	rɔ\.seew
រសោង	rɔ\.saoŋ
រសោះ	rɔ\.sɑh
រហក់	rɔ\.hɑk
រហង់	rɔ\.hɑŋ
រហាច	rɔ\.haac
រហាម	rɔ\.haam
រហាល	rɔ\.haal
រហិក	rɔ\.hək
រហិច	rɔ\.həc
រហិល	rɔ\.həl
រហឹម	rɔ\.həm
រហុយ	rɔ\.hoj
រហូត	rɔ\.hoot
រហូន	rɔ\.hoon
រហើង	rɔ\.haəŋ
រហើត	rɔ\.haət
រហើយ	rɔ\.haəj
រហៀង	rɔ\.hiəŋ
រហៀរ	rɔ\.hiə
រហេម	rɔ\.heem
រហេវ	rɔ\.heew
រហែក	rɔ\.haek
រហែង	rɔ\.haeŋ
រហែល	rɔ\.hael
រហោក	rɔ\.haok
រហោល	rɔ\.haol
រហោស	rɔ\.haoh
រឡប់	rɔ\.lɑp
រឡាញ	rɔ\.laaɲ
រឡាម	rɔ\.laam
រឡឺម	rɔ\.ləəm
រឡូង	rɔ\.looŋ
រអាង	rɔ\.ʔaaŋ
រអាត	rɔ\.ʔaat
រអាម	rɔ\.ʔaam
រអិច	rɔ\.ʔəc
រអិល	rɔ\.ʔəl
រអឹក	rɔ\.ʔək
រអឺត	rɔ\.ʔəət
រអុច	rɔ\.ʔoc
រអូច	rɔ\.ʔooc
រអើប	rɔ\.ʔaəp
រអើម	rɔ\.ʔaəm
រអើល	rɔ\.ʔaəl
រអៀច	rɔ\.ʔiəc
រអៀស	rɔ\.ʔiəh
រអែក	rɔ\.ʔaek
រអែង	rɔ\.ʔaeŋ
រអោក	rɔ\.ʔaok
រអ៊ូ	rɔ\.ʔuu
រាក់	reak
រាត់	roat
រាន់	roan
រាប់	roap
រាល់	roal
រាស់	roah
រាំង	reaŋ
រំងក	rum\.ŋɔɔk
រំជា	rum\.cie
រំជែ	rum\.cɛɛ
រំទំ	rum\.tum
រំពង	rum\.pɔɔŋ
រំពា	rum\.pie
រំពេ	rum\.pee
រំពៃ	rum\.pej
រំលង	rum\.lɔɔŋ
រំលា	rum\.lie
រំលំ	rum\.lum
រំហែ	rum\.hae
រំអា	rum\.ʔaa
រ៉ស់	rɑh
រ៉ាង	raaŋ
រ៉ាវ	raaw
រ៉ាំ	ram
រ៉ិល	rəl
រ៉ឹង	rəŋ
រ៉ឺង	rəəŋ
រ៉ុញ	roɲ
រ៉ុយ	roj
រ៉ុល	rol
រ៉ូង	rooŋ
រ៉ើក	raək
រ៉ើង	raəŋ
រ៉េវ	reew
រ៉េះ	reh
រ៉ែង	raeŋ
រ៉ែត	raet
លម្ហ	lum\.hɑɑ
លម្អ	lum\.ʔɑɑ
លលក់	lɔ\.luək
លលឹម	lɔ\.lɨm
លលួង	lɔ\.luəŋ
លាក់	leak
លាត់	loat
លាន់	loan
លាប់	loap
លាស់	loah
លាំង	leaŋ
លំញង	lum\.ɲɔɔŋ
លំនៅ	lum\.nɨw
លំផក	lum\.pʰɑɑk
លំហែ	lum\.hae
លំអង	lum\.ʔɑɑŋ
ល្កម	lkɑɑm
ល្គង	lkɔɔŋ
ល្ងម	lŋɔɔm
ល្បក	lɓɑɑk
ល្បង	lɓɑɑŋ
ល្បី	lɓəj
ល្បះ	lɓah
ល្ពៅ	lpɨw
ល្មម	lmɔɔm
ល្មៃ	lmej
ល្យំ	ljum
ល្វត	lwɔɔt
ល្វា	lwie
ល្វៃ	lwej
ល្ហក	lhɑɑk
ល្ហែ	lhae
ល្អង	lʔɑɑŋ
ល្អី	lʔəj
ល្អះ	lʔah
វណ្ដ	wun\.ɗɑɑ
វាក់	weak
វាត់	woat
វាន់	woan
វាប់	woap
វាល់	woal
វាស់	woah
វាំង	weaŋ
វ៉ង់	wɑŋ
វ៉ាស	waah
វ៉ឺង	wəəŋ
វ៉ឺត	wəət
វ៉ឺយ	wəəj
វ៉ឺះ	wəəh
វ៉ុល	wol
វ៉ូង	wooŋ
វ៉ូត	woot
វ៉ូប	woop
វ៉ូស	wooh
វ៉េវ	weew
វ៉ែត	waet
វ៉ែន	waen
វ៉ែប	waep
វ៉ោប	waop
វ្ហី	whəj
សណ្ដ	sɑn\.ɗɑɑ
សត្វ	sɑ\.twɑɑ
សម្ល	sɑm\.lɑɑ
សសិត	sɑ\.sət
សសឹក	sɑ\.sək
សសុល	sɑ\.sol
សសូល	sɑ\.sool
សសៀរ	sɑ\.siə
សសេះ	sɑ\.seh
សសោះ	sɑ\.sɑh
សាក់	sak
សាច់	sac
សាត់	sat
សាប់	sap
សាល់	sal
សាំង	saŋ
សំកក	sɑm\.kɑɑk
សំគម	sɑm\.kɔɔm
សំងំ	sɑm\.ŋɑm
សំចត	sɑm\.cɑɑt
សំចែ	sɑm\.cae
សំចៃ	sɑm\.caj
សំញៅ	sɑm\.ɲaw
សំដី	sɑm\.ɗəj
សំដៅ	sɑm\.ɗaw
សំណក	sɑm\.nɑɑk
សំណង	sɑm\.nɑɑŋ
សំណើ	sɑm\.naə
សំណៅ	sɑm\.naw
សំណំ	sɑm\.nɑm
សំតត	sɑm\.tɑɑt
សំទល	sɑm\.tɔɔl
សំបក	sɑm\.ɓɑɑk
សំបា	sɑm\.ɓaa
សំពង	sɑm\.pɔɔŋ
សំពូ	sɑm\.puu
សំពៅ	sɑm\.pɨw
សំពះ	sɑm\.peah
សំភី	sɑm\.pʰii
សំរង	sɑm\.rɑɑŋ
សំរែ	sɑm\.rae
សំវរ	sɑm\.wɑɑ
សំសែ	sɑm\.sae
សំឡី	sɑm\.ləj
សំអក	sɑm\.ʔɑɑk
ស៊ប់	sup
ស៊ាន	sien
ស៊ាំ	soam
ស៊ឹង	sɨŋ
ស៊ុត	sut
ស៊ុន	sun
ស៊ុម	sum
ស៊ើក	səək
ស៊ើប	səəp
ស៊ែម	sɛɛm
ស្កក	skɑɑk
ស្ករ	skɑɑ
ស្កា	skaa
ស្កះ	skah
ស្គម	skɔɔm
ស្គរ	skɔɔ
ស្គា	skie
ស្គឺ	skɨɨ
ស្ញែ	sɲae
ស្ដី	sɗəj
ស្ដៅ	sɗaw
ស្តត	stɑɑt
ស្តា	staa
ស្តោ	stao
ស្ទង	stɔɔŋ
ស្ទប	stɔɔp
ស្ទល	stɔɔl
ស្ទា	stie
ស្ទែ	stɛɛ
ស្ទៃ	stej
ស្ទំ	stum
ស្ទះ	steah
ស្នង	snɑɑŋ
ស្នប	snɑɑp
ស្នល	snɑɑl
ស្នា	snaa
ស្នួ	snuə
ស្នើ	snaə
ស្នោ	snao
ស្នំ	snɑm
ស្បែ	sɓae
ស្បៃ	sɓaj
ស្ពក	spɔɔk
ស្ពឺ	spɨɨ
ស្ពៃ	spej
ស្ពៅ	spɨw
ស្មង	smɑɑŋ
ស្មា	smaa
ស្មឺ	sməə
ស្មើ	smaə
ស្មេ	smee
ស្មែ	smae
ស្មៅ	smaw
ស្យា	sjaa
ស្រក	srɑɑk
ស្រង	srɑɑŋ
ស្រប	srɑɑp
ស្រស	srɑɑh
ស្រា	sraa
ស្រី	srəj
ស្រែ	srae
ស្រំ	srɑm
ស្លត	slɑɑt
ស្លប	slɑɑp
ស្លា	slaa
ស្លឺ	sləə
ស្លែ	slae
ស្លោ	slao
ស្លៅ	slaw
ស្វត	swɑɑt
ស្វា	swaa
ស្វះ	swah
ស្អក	sʔɑɑk
ស្អយ	sʔɑɑj
ស្អា	sʔaa
ស្អី	sʔəj
ស្អំ	sʔɑm
ហាក់	hak
ហាច់	hac
ហាត់	hat
ហាន់	han
ហាប់	hap
ហ៊ាន	hien
ហ៊ិះ	hih
ហ៊ីង	hiiŋ
ហ៊ឹក	hɨk
ហ៊ឹង	hɨŋ
ហ៊ឹប	hɨp
ហ៊ឹម	hɨm
ហ៊ឹះ	hɨh
ហ៊ឺយ	hɨɨj
ហ៊ុន	hun
ហ៊ុម	hum
ហ៊ុះ	huh
ហ៊ើយ	həəj
ហ៊ែះ	hɛh
ហ្មង	hmɑɑŋ
ហ្មប	hmɑɑp
ហ្មេ	hmee
ហ្វេ	hwee
ហ្វៅ	hwaw
ឡាក់	lak
ឡាញ់	laɲ
ឡាន់	lan
ឡាំង	laŋ
អគ្រ	ʔɑ\.krɔɔ
អនុជ	ʔɑ\.noc
អម្រ	ʔɑm\.rɑɑ
អាក់	ʔak
អាត់	ʔat
អាប់	ʔap
អាំង	ʔaŋ
អំណរ	ʔɑm\.nɑɑ
អំពក	ʔɑm\.pɔɔk
អំពី	ʔɑm\.pii
អំពើ	ʔɑm\.pəə
អំពែ	ʔɑm\.pɛɛ
អំពៅ	ʔɑm\.pɨw
អំពះ	ʔɑm\.peah
អ៊ិម	ʔɨm
អ៊ឹម	ʔɨm
អ៊ឹះ	ʔɨh
អ៊ឺត	ʔɨɨt
អ៊ឺះ	ʔɨɨh
អ៊ុត	ʔut
អ៊ុយ	ʔuj
អ៊ូង	ʔuuŋ
អ៊ូច	ʔuuc
អ៊ូញ	ʔuuɲ
អ៊ូយ	ʔuuj
អ៊ែន	ʔɛɛn
អ្នក	ʔnɑɑk
អ្ហា	ʔhaa
អ្ហឺ	ʔhəə
អ្ហូ	ʔhoo
អ្ហោ	ʔhao
អ្ហះ	ʔhah
កញ្ចក	kɑɲ\.cɑɑk
កញ្ចែ	kɑɲ\.cae
កញ្ឆត	kɑɲ\.cʰɑɑt
កញ្ឆល	kɑɲ\.cʰɑɑl
កញ្ឆា	kɑɲ\.cʰaa
កញ្ជរ	kɑɲ\.cɔɔ
កញ្ជួ	kɑɲ\.cuə
កញ្ជើ	kɑɲ\.cəə
កញ្ជោ	kɑɲ\.coo
កញ្ជះ	kɑɲ\.ceah
កណ្ដប	kɑn\.ɗɑɑp
កន្តូ	kɑn\.too
កន្ទប	kɑn\.tɔɔp
កន្ទី	kɑn\.tii
កន្ធរ	kɑn\.tʰɔɔ
កន្ធា	kɑn\.tʰie
កន្លង	kɑn\.lɑɑŋ
កន្លះ	kɑn\.lah
កន្សៃ	kɑn\.saj
កម្ចី	kɑm\.cəj
កម្ញី	kɑm\.ɲəj
កម្ដៅ	kɑm\.ɗaw
កម្ទរ	kɑm\.tɔɔ
កម្រង	kɑm\.rɑɑŋ
កម្រៃ	kɑm\.raj
កម្លា	kɑm\.laa
កម្លៅ	kɑm\.law
កំចាយ	kɑm\.caaj
កំចោក	kɑm\.caok
កំញាន	kɑm\.ɲaan
កំញើញ	kɑm\.ɲaəɲ
កំដឹង	kɑm\.ɗəŋ
កំណត់	kɑm\.nɑt
កំណប់	kɑm\.nɑp
កំណល់	kɑm\.nɑl
កំណាច	kɑm\.naac
កំណារ	kɑm\.naa
កំណិន	kɑm\.nən
កំណួច	kɑm\.nuəc
កំណើត	kɑm\.naət
កំណើន	kɑm\.naən
កំណើល	kɑm\.naəl
កំណៀង	kɑm\.niəŋ
កំណៀច	kɑm\.niəc
កំណៀរ	kɑm\.niə
កំណៀវ	kɑm\.niəw
កំណៀស	kɑm\.niəh
កំណេះ	kɑm\.neh
កំណែន	kɑm\.naen
កំណោង	kɑm\.naoŋ
កំណោត	kɑm\.naot
កំណោន	kɑm\.naon
កំណោរ	kɑm\.nao
កំណោស	kɑm\.naoh
កំណោះ	kɑm\.nɑh
កំនួច	kɑm\.nuəc
កំនៀរ	kɑm\.niə
កំបាប	kɑm\.ɓaap
កំបុត	kɑm\.ɓot
កំបូវ	kɑm\.ɓoow
កំបែក	kɑm\.ɓaek
កំបែប	kɑm\.ɓaep
កំបោរ	kɑm\.ɓao
កំផិត	kɑm\.pʰət
កំផែង	kɑm\.pʰaeŋ
កំផែល	kɑm\.pʰael
កំពង់	kɑm\.puŋ
កំពប់	kɑm\.pup
កំពាង	kɑm\.pieŋ
កំពាញ	kɑm\.pieɲ
កំពាយ	kɑm\.piej
កំពីង	kɑm\.piiŋ
កំពឹស	kɑm\.pɨh
កំពុក	kɑm\.puk
កំពុង	kɑm\.puŋ
កំពូក	kɑm\.puuk
កំពូជ	kɑm\.puuc
កំពូល	kɑm\.puul
កំពួរ	kɑm\.puə
កំពើង	kɑm\.pəəŋ
កំពៀច	kɑm\.piəc
កំពែង	kɑm\.pɛɛŋ
កំពោង	kɑm\.pooŋ
កំភូត	kɑm\.pʰuut
កំភួន	kɑm\.pʰuən
កំភេម	kɑm\.pʰeem
កំភែល	kɑm\.pʰɛɛl
កំរើប	kɑm\.raəp
កំរោល	kɑm\.raol
កំលុង	kɑm\.loŋ
កំលោះ	kɑm\.lɑh
កំសាក	kɑm\.saak
កំសុល	kɑm\.sol
កំសួល	kɑm\.suəl
កំសៀវ	kɑm\.siəw
កំហល់	kɑm\.hɑl
កំហាក	kɑm\.haak
កំហាត	kɑm\.haat
កំហាន	kɑm\.haan
កំហិត	kɑm\.hət
កំហិល	kɑm\.həl
កំហឹង	kɑm\.həŋ
កំហុល	kɑm\.hol
កំហុស	kɑm\.hoh
កំហូច	kɑm\.hooc
កំហើច	kɑm\.haəc
កំហែង	kɑm\.haeŋ
កំហោក	kɑm\.haok
កំអួក	kɑm\.ʔuək
ក្ងក់	kŋɑk
ក្ងង់	kŋɑŋ
ក្ងាន	kŋaan
ក្ងិច	kŋəc
ក្ងិត	kŋət
ក្ងុក	kŋok
ក្ងុង	kŋoŋ
ក្ងុល	kŋol
ក្ងុះ	kŋoh
ក្ងួរ	kŋuə
ក្ងៀក	kŋiək
ក្ងៀង	kŋiəŋ
ក្ងេះ	kŋeh
ក្ងែង	kŋaeŋ
ក្ងោក	kŋaok
ក្ដក់	kɗɑk
ក្ដន់	kɗɑn
ក្ដាត	kɗaat
ក្ដាម	kɗaam
ក្ដារ	kɗaa
ក្ដាំ	kɗam
ក្ដិច	kɗəc
ក្ដិត	kɗət
ក្ដឹប	kɗəp
ក្ដឹះ	kɗəh
ក្ដុក	kɗok
ក្ដុង	kɗoŋ
ក្ដុល	kɗol
ក្ដួច	kɗuəc
ក្ដួល	kɗuəl
ក្ដឿង	kɗɨəŋ
ក្ដៀន	kɗiən
ក្ដៀប	kɗiəp
ក្ដែង	kɗaeŋ
ក្ដោង	kɗaoŋ
ក្ដោប	kɗaop
ក្ឌឺង	kɗɨɨŋ
ក្ឌុក	kɗuk
ក្ឌុង	kɗuŋ
ក្ឌុំ	kɗum
ក្នក់	knɑk
ក្និច	knəc
ក្នុង	knoŋ
ក្បង់	kɓɑŋ
ក្បត់	kɓɑt
ក្បាន	kɓaan
ក្បាប	kɓaap
ក្បាយ	kɓaaj
ក្បាល	kɓaal
ក្បិត	kɓət
ក្បិន	kɓən
ក្បិល	kɓəl
ក្បឺត	kɓəət
ក្បុង	kɓoŋ
ក្បុស	kɓoh
ក្បូន	kɓoon
ក្បូរ	kɓoo
ក្បួន	kɓuən
ក្បឿង	kɓɨəŋ
ក្បៀប	kɓiəp
ក្បៀស	kɓiəh
ក្បេត	kɓeet
ក្បែរ	kɓae
ក្បោះ	kɓɑh
ក្មាង	kmaaŋ
ក្មួយ	kmuəj
ក្មេក	kmeek
ក្មេង	kmeeŋ
ក្រកី	krɑ\.kəj
ក្រកោ	krɑ\.kao
ក្រគរ	krɑ\.kɔɔ
ក្រង់	krɑŋ
ក្រចក	krɑ\.cɑɑk
ក្រចេ	krɑ\.cee
ក្រចៅ	krɑ\.caw
ក្រញរ	krɑ\.ɲɑɑ
ក្រញី	krɑ\.ɲəj
ក្រញៅ	krɑ\.ɲaw
ក្រទា	krɑ\.tie
ក្រទី	krɑ\.tii
ក្រទែ	krɑ\.tɛɛ
ក្របី	krɑ\.ɓəj
ក្របៅ	krɑ\.ɓaw
ក្រពក	krɑ\.pɔɔk
ក្រពង	krɑ\.pɔɔŋ
ក្រពត	krɑ\.pɔɔt
ក្រពា	krɑ\.pie
ក្រពើ	krɑ\.pəə
ក្រពះ	krɑ\.peah
ក្រមម	krɑ\.mɑɑm
ក្រមរ	krɑ\.mɑɑ
ក្រមា	krɑ\.maa
ក្រមី	krɑ\.məj
ក្រមៅ	krɑ\.maw
ក្រយា	krɑ\.jaa
ក្រយៅ	krɑ\.jaw
ក្រសែ	krɑ\.sae
ក្រហត	krɑ\.hɑɑt
ក្រហម	krɑ\.hɑɑm
ក្រឡក	krɑ\.lɑɑk
ក្រឡា	krɑ\.laa
ក្រឡែ	krɑ\.lae
ក្រឡោ	krɑ\.lao
ក្រឡៅ	krɑ\.law
ក្រាក	kraak
ក្រាញ	kraaɲ
ក្រាន	kraan
ក្រាប	kraap
ក្រាម	kraam
ក្រាយ	kraaj
ក្រាល	kraal
ក្រាស	kraah
ក្រិត	krət
ក្រិន	krən
ក្រិប	krəp
ក្រិះ	kreh
ក្រឹក	krək
ក្រឹប	krəp
ក្រឹម	krəm
ក្រឹស	krəh
ក្រឺត	krəət
ក្រុក	krok
ក្រុង	kroŋ
ក្រុប	krop
ក្រុស	kroh
ក្រូច	krooc
ក្រួច	kruəc
ក្រួប	kruəp
ក្រួស	kruəh
ក្រើន	kraən
ក្រៀក	kriək
ក្រៀប	kriəp
ក្រៀម	kriəm
ក្រៀល	kriəl
ក្រៀវ	kriəw
ក្រេប	kreep
ក្រេវ	kreew
ក្រេស	kreeh
ក្រេះ	kreh
ក្រែក	kraek
ក្រែង	kraeŋ
ក្រែប	kraep
ក្រែល	krael
ក្រែះ	kraeh
ក្រោក	kraok
ក្រោម	kraom
ក្រោយ	kraoj
ក្រោល	kraol
ក្រោះ	krɑh
ក្លស់	klɑh
ក្លាយ	klaaj
ក្លាវ	klaaw
ក្លាំ	klam
ក្លិត	klət
ក្លិន	klən
ក្លឹង	kləŋ
ក្លឹស	kləh
ក្លុក	klok
ក្លុំ	klom
ក្លៀក	kliək
ក្លេត	kleet
ក្លែង	klaeŋ
ក្លែប	klaep
ក្លែម	klaem
ក្វាង	kwaaŋ
ក្វាត	kwaat
ក្វែន	kwaen
ក្អាក	kʔaak
ក្អាង	kʔaaŋ
ក្អាត	kʔaat
ក្អិត	kʔət
ក្អិល	kʔəl
ក្អឹក	kʔək
ក្អុក	kʔok
ក្អួត	kʔuət
ក្អឿយ	kʔɨəj
ក្អៀក	kʔiək
ក្អេង	kʔeeŋ
ក្អែក	kʔaek
ក្អែប	kʔaep
ក្អែល	kʔael
ខ្ចប់	kcɑp
ខ្ចាយ	kcaaj
ខ្ចូវ	kcoow
ខ្ចើច	kcaəc
ខ្ចោត	kcaot
ខ្ចោប	kcaop
ខ្ចោះ	kcɑh
ខ្ជាក	kciek
ខ្ជាង	kcieŋ
ខ្ជាយ	kciej
ខ្ជាំ	kcoam
ខ្ជិល	kcɨl
ខ្ជឹង	kcɨŋ
ខ្ជឹប	kcɨp
ខ្ជួន	kcuən
ខ្ជើច	kcəəc
ខ្ជេញ	kceeɲ
ខ្ជែង	kcɛɛŋ
ខ្ជោក	kcook
ខ្ជោល	kcool
ខ្ញង់	kɲɑŋ
ខ្ញាក	kɲaak
ខ្ញារ	kɲaa
ខ្ញាំ	kɲam
ខ្ញិក	kɲək
ខ្ញិល	kɲəl
ខ្ញឹង	kɲəŋ
ខ្ញុង	kɲoŋ
ខ្ញូច	kɲooc
ខ្ញើច	kɲaəc
ខ្ញៀវ	kɲiəw
ខ្ញែក	kɲaek
ខ្ញែត	kɲaet
ខ្ញែម	kɲaem
ខ្ញែរ	kɲae
ខ្ញោក	kɲaok
ខ្ទង់	ktuŋ
ខ្ទប់	ktup
ខ្ទាត	ktiet
ខ្ទារ	ktie
ខ្ទាំ	ktoam
ខ្ទិះ	ktih
ខ្ទីង	ktiiŋ
ខ្ទីត	ktiit
ខ្ទឹង	ktɨŋ
ខ្ទឹម	ktɨm
ខ្ទុត	ktut
ខ្ទុះ	ktuh
ខ្ទួយ	ktuəj
ខ្ទើត	ktəət
ខ្ទើយ	ktəəj
ខ្ទេច	kteec
ខ្ទែង	ktɛɛŋ
ខ្ទែត	ktɛɛt
ខ្ទោក	ktook
ខ្នន់	knɑn
ខ្នប់	knɑp
ខ្នល់	knɑl
ខ្នាច	knaac
ខ្នាត	knaat
ខ្នាន	knaan
ខ្នាប	knaap
ខ្នាយ	knaaj
ខ្នារ	knaa
ខ្និច	knəc
ខ្និត	knət
ខ្នឺប	knəəp
ខ្នុរ	kno
ខ្នួច	knuəc
ខ្នួត	knuət
ខ្នើត	knaət
ខ្នើយ	knaəj
ខ្នៀរ	kniə
ខ្នៀស	kniəh
ខ្នែង	knaeŋ
ខ្នោស	knaoh
ខ្នោះ	knɑh
ខ្ពង់	kpuŋ
ខ្ពស់	kpuəh
ខ្ពាក	kpiek
ខ្ពុក	kpuk
ខ្ពុរ	kpu
ខ្ពើម	kpəəm
ខ្ពោក	kpook
ខ្មាយ	kmaaj
ខ្មាស	kmaah
ខ្មឺត	kməət
ខ្មុក	kmok
ខ្មុល	kmol
ខ្មូត	kmoot
ខ្មូរ	kmoo
ខ្មួញ	kmuəɲ
ខ្មួយ	kmuəj
ខ្មួរ	kmuə
ខ្មួល	kmuəl
ខ្មេរ	kmee
ខ្មេះ	kmeh
ខ្មែរ	kmae
ខ្មោច	kmaoc
ខ្មោះ	kmɑh
ខ្យល់	kjɑl
ខ្លាច	klaac
ខ្លឹម	kləm
ខ្លឺត	kləət
ខ្លុក	klok
ខ្លុង	kloŋ
ខ្លុយ	kloj
ខ្លុះ	kloh
ខ្លូត	kloot
ខ្លួន	kluən
ខ្លេវ	kleew
ខ្លែង	klaeŋ
ខ្លោង	klaoŋ
ខ្លោច	klaoc
ខ្លោញ	klaoɲ
ខ្លោត	klaot
ខ្វក់	kwɑk
ខ្វង់	kwɑŋ
ខ្វល់	kwɑl
ខ្វាក	kwaak
ខ្វាង	kwaaŋ
ខ្វាច	kwaac
ខ្វាន	kwaan
ខ្វាម	kwaam
ខ្វារ	kwaa
ខ្វាវ	kwaaw
ខ្វាស	kwaah
ខ្វិច	kwəc
ខ្វិន	kwən
ខ្វិល	kwəl
ខ្វើក	kwaək
ខ្វើយ	kwaəj
ខ្វៀក	kwiək
ខ្វៀន	kwiən
ខ្វៀប	kwiəp
ខ្វេរ	kwee
ខ្វេះ	kweh
ខ្វែក	kwaek
ខ្វែង	kwaeŋ
ខ្វែត	kwaet
ខ្វែវ	kwaew
ខ្វែះ	kwaeh
ខ្វោក	kwaok
ខ្វោះ	kwɑh
ខ្សាក	ksaak
ខ្សាន	ksaan
ខ្សាប	ksaap
ខ្សាយ	ksaaj
ខ្សាវ	ksaaw
ខ្សឹប	ksəp
ខ្សឺត	ksəət
ខ្សុក	ksok
ខ្សុច	ksoc
ខ្សុយ	ksoj
ខ្សុល	ksol
ខ្សួល	ksuəl
ខ្សួស	ksuəh
ខ្សៀក	ksiək
ខ្សៀវ	ksiəw
ខ្សេវ	kseew
ខ្សោយ	ksaoj
ខ្សោះ	ksɑh
គជ្រា	kɔ\.crie
គន្លង	kun\.lɔɔŋ
គប្បី	kɔ\.pɓəj
គម្រង	kum\.rɔɔŋ
គម្រប	kum\.rɔɔp
គំនក់	kum\.nuək
គំនង់	kum\.nuŋ
គំនន់	kum\.nun
គំនាត	kum\.niet
គំនាប	kum\.niep
គំនិត	kum\.nɨt
គំនុំ	kum\.num
គំនូរ	kum\.nuu
គំនូស	kum\.nuuh
គំនួប	kum\.nuəp
គំនួរ	kum\.nuə
គំនោះ	kum\.nuəh
គំរង់	kum\.ruŋ
គំរាម	kum\.riem
គំរឹល	kum\.rɨl
គំរើយ	kum\.rəəj
គំរេច	kum\.reec
គំរោះ	kum\.ruəh
គំហឹន	kum\.hən
គំហុក	kum\.hok
គំហែត	kum\.haet
គ្នេរ	knee
គ្មាន	kmien
គ្រក់	kruək
គ្រង់	kruŋ
គ្រប់	krup
គ្រមរ	krɔ\.mɔɔ
គ្រលរ	krɔ\.lɔɔ
គ្រលស	krɔ\.lɔɔh
គ្រវី	krɔ\.wii
គ្រហរ	krɔ\.hɑɑ
គ្រហូ	krɔ\.hoo
គ្រហើ	krɔ\.haə
គ្រាក	kriek
គ្រាង	krieŋ
គ្រាវ	kriew
គ្រាស	krieh
គ្រាំ	kroam
គ្រាះ	krieh
គ្រិច	krɨc
គ្រីប	kriip
គ្រឹក	krɨk
គ្រឹប	krɨp
គ្រឹម	krɨm
គ្រឺត	krɨɨt
គ្រុក	kruk
គ្រុន	krun
គ្រុប	krup
គ្រុម	krum
គ្រុយ	kruj
គ្រុំ	krum
គ្រុះ	kruh
គ្រូក	kruuk
គ្រួប	kruəp
គ្រើម	krəəm
គ្រើល	krəəl
គ្រឿង	krɨəŋ
គ្រឿន	krɨən
គ្រៀវ	kriəw
គ្រៀស	kriəh
គ្រេង	kreeŋ
គ្រេច	kreec
គ្រែង	krɛɛŋ
គ្រោង	krooŋ
គ្រោត	kroot
គ្វាម	kwiem
ឃ្ញើច	kɲəəc
ឃ្នាង	knieŋ
ឃ្នាប	kniep
ឃ្នូស	knuuh
ឃ្នើស	knəəh
ឃ្មង់	kmuŋ
ឃ្មត់	kmut
ឃ្មាម	kmiem
ឃ្មឹក	kmɨk
ឃ្មឹល	kmɨl
ឃ្មុំ	kmum
ឃ្មោះ	kmuəh
ឃ្លង់	kluŋ
ឃ្លាត	kliet
ឃ្លាំ	kloam
ឃ្លុក	kluk
ឃ្លុប	klup
ឃ្លុំ	klum
ឃ្លួប	kluəp
ឃ្លៀង	kliəŋ
ឃ្លៀច	kliəc
ឃ្លោក	klook
ឃ្លោង	klooŋ
ឃ្វាង	kwieŋ
ឃ្វាច	kwiec
ឃ្វាម	kwiem
ឃ្វាយ	kwiej
ឃ្វាល	kwiel
ឃ្វិច	kwɨc
ឃ្វើង	kwəəŋ
ឃ្វើច	kwəəc
ងង៉េស	ŋɔ\.ŋeeh
ង៉ាញ់	ŋaɲ
ង៉ាំង	ŋaŋ
ចង្កា	cɑŋ\.kaa
ចង្កំ	cɑŋ\.kɑm
ចង្រក	cɑŋ\.rɑɑk
ចង្រៃ	cɑŋ\.raj
ចង្វា	cɑŋ\.waa
ចន្ទី	cɑn\.tii
ចម្កយ	cɑm\.kɑɑj
ចម្បង	cɑm\.ɓɑɑŋ
ចម្រក	cɑm\.rɑɑk
ចម្លង	cɑm\.lɑɑŋ
ចំកាង	cɑm\.kaaŋ
ចំកោង	cɑm\.kaoŋ
ចំណង់	cɑm\.nɑŋ
ចំណត់	cɑm\.nɑt
ចំណាន	cɑm\.naan
ចំណាយ	cɑm\.naaj
ចំណារ	cɑm\.naa
ចំណាល	cɑm\.naal
ចំណាំ	cɑm\.nam
ចំណិត	cɑm\.nət
ចំណឹក	cɑm\.nək
ចំណឹប	cɑm\.nəp
ចំណុក	cɑm\.nok
ចំណុច	cɑm\.noc
ចំណុះ	cɑm\.noh
ចំណូក	cɑm\.nook
ចំណូរ	cɑm\.noo
ចំណូល	cɑm\.nool
ចំណៀស	cɑm\.niəh
ចំណេញ	cɑm\.neeɲ
ចំណេរ	cɑm\.nee
ចំណេះ	cɑm\.neh
ចំណែក	cɑm\.naek
ចំណែង	cɑm\.naeŋ
ចំណែវ	cɑm\.naew
ចំណោត	cɑm\.naot
ចំណោទ	cɑm\.naot
ចំណោម	cɑm\.naom
ចំណោល	cɑm\.naol
ចំណោះ	cɑm\.nɑh
ចំតិត	cɑm\.tət
ចំតូង	cɑm\.tooŋ
ចំតើត	cɑm\.taət
ចំទង់	cɑm\.tuŋ
ចំទាញ	cɑm\.tieɲ
ចំទាល	cɑm\.tiel
ចំទួយ	cɑm\.tuəj
ចំទើត	cɑm\.təət
ចំទើរ	cɑm\.təə
ចំទើស	cɑm\.təəh
ចំទែង	cɑm\.tɛɛŋ
ចំនួន	cɑm\.nuən
ចំនួប	cɑm\.nuəp
ចំនៀរ	cɑm\.niə
ចំបក់	cɑm\.ɓɑk
ចំបួរ	cɑm\.ɓuə
ចំបើង	cɑm\.ɓaəŋ
ចំបែង	cɑm\.ɓaeŋ
ចំប៉ី	cɑm\.pəj
ចំពប់	cɑm\.pup
ចំពិត	cɑm\.pɨt
ចំពុះ	cɑm\.puh
ចំពូក	cɑm\.puuk
ចំពួក	cɑm\.puək
ចំពួយ	cɑm\.puəj
ចំពើប	cɑm\.pəəp
ចំពោះ	cɑm\.puəh
ចំលៀវ	cɑm\.liəw
ចំហាប	cɑm\.haap
ចំហាយ	cɑm\.haaj
ចំហុង	cɑm\.hoŋ
ចំហុត	cɑm\.hot
ចំហុយ	cɑm\.hoj
ចំហូវ	cɑm\.hoow
ចំហួល	cɑm\.huəl
ចំហៀង	cɑm\.hiəŋ
ចំហៀវ	cɑm\.hiəw
ចំហេះ	cɑm\.heh
ចំឡក់	cɑm\.lɑk
ចំអន់	cɑm\.ʔɑn
ចំអាម	cɑm\.ʔaam
ចំអាស	cɑm\.ʔaah
ចំអើត	cɑm\.ʔaət
ចំអៀក	cɑm\.ʔiək
ចំអេង	cɑm\.ʔeeŋ
ច្នឹង	cnəŋ
ច្នេះ	cneh
ច្នោះ	cnɑh
ច្បាម	cɓaam
ច្បារ	cɓaa
ច្បិច	cɓəc
ច្បុច	cɓoc
ច្បូក	cɓook
ច្បូត	cɓoot
ច្បែប	cɓaep
ច្បោល	cɓaol
ច្បោស	cɓaoh
ច្បោះ	cɓɑh
ច្រក់	crɑk
ច្រងោ	crɑ\.ŋao
ច្រង់	crɑŋ
ច្រត់	crɑt
ច្រប់	crɑp
ច្រវា	crɑ\.waa
ច្រឡៃ	crɑ\.laj
ច្រឡោ	crɑ\.lao
ច្រឡំ	crɑ\.lɑm
ច្រអរ	crɑ\.ʔɑɑ
ច្រាក	craak
ច្រាង	craaŋ
ច្រាញ	craaɲ
ច្រាន	craan
ច្រាប	craap
ច្រាល	craal
ច្រាវ	craaw
ច្រាស	craah
ច្រិច	crəc
ច្រិល	crəl
ច្រឹក	crək
ច្រឹង	crəŋ
ច្រឹប	crəp
ច្រឺះ	crəəh
ច្រុង	croŋ
ច្រុប	crop
ច្រុម	crom
ច្រុះ	croh
ច្រូង	crooŋ
ច្រូច	crooc
ច្រូត	croot
ច្រួច	cruəc
ច្រួល	cruəl
ច្រើន	craən
ច្រៀក	criək
ច្រៀង	criəŋ
ច្រៀច	criəc
ច្រៀប	criəp
ច្រេច	creec
ច្រេស	creeh
ច្រេះ	creh
ច្រែង	craeŋ
ច្រែត	craet
ច្រែស	craeh
ច្រែះ	craeh
ច្រោក	craok
ច្រោង	craoŋ
ច្រោះ	crɑh
ឆន្ទា	cʰɑn\.tie
ឆ្កាង	ckaaŋ
ឆ្ការ	ckaa
ឆ្កិល	ckəl
ឆ្កឹង	ckəŋ
ឆ្កឹះ	ckəh
ឆ្កឺត	ckəət
ឆ្កុយ	ckoj
ឆ្កូត	ckoot
ឆ្កួត	ckuət
ឆ្កៀល	ckiəl
ឆ្កៀស	ckiəh
ឆ្កោក	ckaok
ឆ្គាំ	ckoam
ឆ្ងក់	cŋɑk
ឆ្ងល់	cŋɑl
ឆ្ងាយ	cŋaaj
ឆ្ងិត	cŋət
ឆ្ងឹង	cŋəŋ
ឆ្ងុយ	cŋoj
ឆ្ងូវ	cŋoow
ឆ្ងើក	cŋaək
ឆ្ងើយ	cŋaəj
ឆ្ដុប	cɗop
ឆ្ដេញ	cɗeeɲ
ឆ្ដោរ	cɗao
ឆ្នង់	cnɑŋ
ឆ្នាស	cnaah
ឆ្នាំ	cnam
ឆ្នឹម	cnəm
ឆ្នុក	cnok
ឆ្នូត	cnoot
ឆ្នួន	cnuən
ឆ្នើម	cnaəm
ឆ្នៀង	cniəŋ
ឆ្នេរ	cnee
ឆ្នែង	cnaeŋ
ឆ្នោត	cnaot
ឆ្ពង់	cpuŋ
ឆ្ពាម	cpiem
ឆ្ពិត	cpɨt
ឆ្ពិន	cpɨn
ឆ្ពឹះ	cpɨh
ឆ្ពុង	cpuŋ
ឆ្ពោះ	cpuəh
ឆ្មក់	cmɑk
ឆ្មារ	cmaa
ឆ្មាំ	cmam
ឆ្មូល	cmool
ឆ្មើង	cmaəŋ
ឆ្មៀង	cmiəŋ
ឆ្លាត	claat
ឆ្លាម	claam
ឆ្លាស	claah
ឆ្លឺម	cləəm
ឆ្លុះ	cloh
ឆ្លូក	clook
ឆ្លូង	clooŋ
ឆ្លូញ	clooɲ
ឆ្លូវ	cloow
ឆ្លើយ	claəj
ឆ្លៀត	cliət
ឆ្លែក	claek
ឆ្លោង	claoŋ
ឆ្វង់	cwɑŋ
ឆ្វាក	cwaak
ឆ្វាង	cwaaŋ
ឆ្វាច	cwaac
ឆ្វាយ	cwaaj
ឆ្វៀល	cwiəl
ឆ្វេង	cweeŋ
ឆ្វេះ	cweh
ឆ្វែល	cwael
ឆ្អន់	cʔɑn
ឆ្អល់	cʔɑl
ឆ្អាប	cʔaap
ឆ្អិត	cʔət
ឆ្អិន	cʔən
ឆ្អឹង	cʔəŋ
ឆ្អឺស	cʔəəh
ឆ្អើម	cʔaəm
ឆ្អើរ	cʔaə
ឆ្អេះ	cʔeh
ឆ្អែង	cʔaeŋ
ឆ្អែត	cʔaet
ជង្ឃា	cuŋ\.kʰie
ជជ្រក	cɔ\.crɔɔk
ជម្នះ	cum\.neah
ជម្រក	cum\.rɔɔk
ជម្រៅ	cum\.rɨw
ជម្រះ	cum\.reah
ជំទង់	cum\.tuŋ
ជំទប់	cum\.tup
ជំទាញ	cum\.tieɲ
ជំទាវ	cum\.tiew
ជំទួយ	cum\.tuəj
ជំទើរ	cum\.təə
ជំទើស	cum\.təəh
ជំទែង	cum\.tɛɛŋ
ជំនក់	cum\.nuək
ជំនង់	cum\.nuŋ
ជំនច់	cum\.nuc
ជំនន់	cum\.nun
ជំនាង	cum\.nieŋ
ជំនាញ	cum\.nieɲ
ជំនាវ	cum\.niew
ជំនិត	cum\.nɨt
ជំនិះ	cum\.nih
ជំនីក	cum\.niik
ជំនីប	cum\.niip
ជំនុំ	cum\.num
ជំនូត	cum\.nuut
ជំនូន	cum\.nuun
ជំនួញ	cum\.nuəɲ
ជំនួប	cum\.nuəp
ជំនួយ	cum\.nuəj
ជំនួល	cum\.nuəl
ជំនួស	cum\.nuəh
ជំនឿន	cum\.nɨən
ជំនេរ	cum\.nee
ជំនែង	cum\.nɛɛŋ
ជំនោរ	cum\.noo
ជំនោះ	cum\.nuəh
ជំបួរ	cum\.ɓuə
ជំពប់	cum\.pup
ជំពូក	cum\.puuk
ជំរត់	cum\.rut
ជំរិត	cum\.rɨt
ជំរុញ	cum\.ruɲ
ជំរឿន	cum\.rɨən
ជំលាប	cum\.liep
ជំហប់	cum\.hɑp
ជំហាញ	cum\.haaɲ
ជំហាន	cum\.haan
ជំហូស	cum\.hooh
ជំហោង	cum\.haoŋ
ជ្រក់	cruək
ជ្រងោ	crɔ\.ŋoo
ជ្រងំ	crɔ\.ŋum
ជ្រង់	cruŋ
ជ្រញ់	cruɲ
ជ្រប់	crup
ជ្រលង	crɔ\.lɔɔŋ
ជ្រលម	crɔ\.lɔɔm
ជ្រហម	crɔ\.hɑɑm
ជ្រាក	criek
ជ្រាប	criep
ជ្រាម	criem
ជ្រាយ	criej
ជ្រាល	criel
ជ្រាវ	criew
ជ្រាស	crieh
ជ្រាំ	croam
ជ្រិះ	crih
ជ្រីវ	criiw
ជ្រឹង	crɨŋ
ជ្រុង	cruŋ
ជ្រុល	crul
ជ្រុះ	cruh
ជ្រូក	cruuk
ជ្រួក	cruək
ជ្រួញ	cruəɲ
ជ្រួត	cruət
ជ្រួយ	cruəj
ជ្រួល	cruəl
ជ្រួស	cruəh
ជ្រើម	crəəm
ជ្រើស	crəəh
ជ្រៀង	criəŋ
ជ្រៀត	criət
ជ្រេញ	creeɲ
ជ្រែក	crɛɛk
ជ្រែង	crɛɛŋ
ជ្រែះ	crɛh
ជ្រោក	crook
ជ្រោង	crooŋ
ជ្រោយ	crooj
ជ្រោះ	cruəh
ឈ្ងប់	cŋup
ឈ្ងុយ	cŋuj
ឈ្ងៀម	cŋiəm
ឈ្ងោក	cŋook
ឈ្នក់	cnuək
ឈ្នាង	cnieŋ
ឈ្នុល	cnul
ឈ្នូត	cnuut
ឈ្នួត	cnuət
ឈ្នួល	cnuəl
ឈ្នៀង	cniəŋ
ឈ្មុល	cmul
ឈ្មុស	cmuh
ឈ្មួញ	cmuəɲ
ឈ្មួយ	cmuəj
ឈ្មៀត	cmiət
ឈ្មោល	cmool
ឈ្មោះ	cmuəh
ឈ្លក់	cluək
ឈ្លប់	clup
ឈ្លាស	clieh
ឈ្លីក	cliik
ឈ្លូស	cluuh
ឈ្លើង	cləəŋ
ឈ្លើយ	cləəj
ឈ្លៀស	cliəh
ឈ្លេច	cleec
ឈ្លេម	cleem
ឈ្លែម	clɛɛm
ឈ្លោះ	cluəh
ឈ្វាត	cwiet
ឈ្វេង	cweeŋ
ញញាក់	ɲɔ\.ɲeak
ញ៉ាច់	ɲac
ញ៉ាំង	ɲaŋ
ដង្កែ	ɗɑŋ\.kae
ដង្កោ	ɗɑŋ\.kao
ដង្ខៅ	ɗɑŋ\.kʰaw
ដង្ហែ	ɗɑŋ\.hae
ដន្លង	ɗɑn\.lɑɑŋ
ដំកង់	ɗɑm\.kɑŋ
ដំងើច	ɗɑm\.ŋaəc
ដំណក់	ɗɑm\.nɑk
ដំណល់	ɗɑm\.nɑl
ដំណាល	ɗɑm\.naal
ដំណាំ	ɗɑm\.nam
ដំណិត	ɗɑm\.nət
ដំណឹង	ɗɑm\.nəŋ
ដំណុត	ɗɑm\.not
ដំណុស	ɗɑm\.noh
ដំណុះ	ɗɑm\.noh
ដំណូច	ɗɑm\.nooc
ដំណូរ	ɗɑm\.noo
ដំណួច	ɗɑm\.nuəc
ដំណួល	ɗɑm\.nuəl
ដំណួស	ɗɑm\.nuəh
ដំណើប	ɗɑm\.naəp
ដំណើរ	ɗɑm\.naə
ដំណៀង	ɗɑm\.niəŋ
ដំណៀល	ɗɑm\.niəl
ដំណេក	ɗɑm\.neek
ដំណេញ	ɗɑm\.neeɲ
ដំណេរ	ɗɑm\.nee
ដំណែង	ɗɑm\.naeŋ
ដំណែល	ɗɑm\.nael
ដំណោច	ɗɑm\.naoc
ដំណោត	ɗɑm\.naot
ដំណោយ	ɗɑm\.naoj
ដំណោល	ɗɑm\.naol
ដំណោះ	ɗɑm\.nɑh
ដំបន់	ɗɑm\.ɓɑn
ដំបារ	ɗɑm\.ɓaa
ដំបូក	ɗɑm\.ɓook
ដំបូង	ɗɑm\.ɓooŋ
ដំបូល	ɗɑm\.ɓool
ដំបួច	ɗɑm\.ɓuəc
ដំរួច	ɗɑm\.ruəc
ដំរួយ	ɗɑm\.ruəj
ដំរៀត	ɗɑm\.riət
ដំរែក	ɗɑm\.raek
ដំឡូង	ɗɑm\.looŋ
ដំឡើង	ɗɑm\.laəŋ
ដំឡោក	ɗɑm\.laok
ដំអក់	ɗɑm\.ʔɑk
ដ្បិត	tɓət
ណ្ហើយ	nhaəj
តង្ករ	tɑŋ\.kɑɑ
តម្រង	tɑm\.rɑɑŋ
តម្រា	tɑm\.raa
តម្លា	tɑm\.laa
តម្លៃ	tɑm\.laj
តំណក់	tɑm\.nɑk
តំណាង	tɑm\.naaŋ
តំណាល	tɑm\.naal
តំណិច	tɑm\.nəc
តំណិះ	tɑm\.neh
តំណឹង	tɑm\.nəŋ
តំណុះ	tɑm\.noh
តំណូច	tɑm\.nooc
តំណែង	tɑm\.naeŋ
តំណោង	tɑm\.naoŋ
តំនឿន	tɑm\.nɨən
តំបន់	tɑm\.ɓɑn
ត្ងោក	tŋaok
ត្នោត	tnaot
ត្បាញ	tɓaaɲ
ត្បារ	tɓaa
ត្បិត	tɓət
ត្បុត	tɓot
ត្បុរ	tɓo
ត្បូង	tɓooŋ
ត្បៀត	tɓiət
ត្បែង	tɓaeŋ
ត្មាត	tmaat
ត្មិល	tməl
ត្មោង	tmaoŋ
ត្មោល	tmaol
ត្រកង	trɑ\.kɑɑŋ
ត្រក់	trɑk
ត្រង់	trɑŋ
ត្រចះ	trɑ\.cah
ត្រជំ	trɑ\.cum
ត្រឈៃ	trɑ\.cʰej
ត្រដរ	trɑ\.ɗɑɑ
ត្រដេ	trɑ\.ɗee
ត្រណម	trɑ\.nɑɑm
ត្របក	trɑ\.ɓɑɑk
ត្របះ	trɑ\.ɓah
ត្រប់	trɑp
ត្រយង	trɑ\.jɑɑŋ
ត្រល់	trɑl
ត្រសង	trɑ\.sɑɑŋ
ត្រស់	trɑh
ត្រឡក	trɑ\.lɑɑk
ត្រអក	trɑ\.ʔɑɑk
ត្រាង	traaŋ
ត្រាច	traac
ត្រាយ	traaj
ត្រាវ	traaw
ត្រាំ	tram
ត្រិល	trəl
ត្រឹក	trək
ត្រឹង	trəŋ
ត្រឹប	trəp
ត្រឹម	trəm
ត្រុក	trok
ត្រុន	tron
ត្រុយ	troj
ត្រុល	trol
ត្រុំ	trom
ត្រូល	trool
ត្រូវ	troow
ត្រួត	truət
ត្រួយ	truəj
ត្រួស	truəh
ត្រើង	traəŋ
ត្រើយ	traəj
ត្រៀក	triək
ត្រៀប	triəp
ត្រៀម	triəm
ត្រៀល	triəl
ត្រេក	treek
ត្រេង	treeŋ
ត្រែង	traeŋ
ត្រែត	traet
ត្រែះ	traeh
ត្រោក	traok
ត្រោស	traoh
ត្លឹង	tləŋ
ត្លុក	tlok
ត្លុង	tloŋ
ត្លុម	tlom
ត្លុំ	tlom
ត្លេវ	tleew
ត្លែត	tlaet
ត្លោត	tlaot
ត្វាង	twaaŋ
ត្អឹង	tʔəŋ
ត្អូញ	tʔooɲ
ត្អួរ	tʔuə
ត្អើក	tʔaək
ថ្កល់	tkɑl
ថ្កាន	tkaan
ថ្កាស	tkaah
ថ្កូវ	tkoow
ថ្កើង	tkaəŋ
ថ្កៀប	tkiəp
ថ្កោល	tkaol
ថ្គាម	tkiem
ថ្គោល	tkool
ថ្ងាស	tŋaah
ថ្ងុង	tŋoŋ
ថ្ងុញ	tŋoɲ
ថ្ងុយ	tŋoj
ថ្ងូរ	tŋoo
ថ្ងូវ	tŋoow
ថ្ងួច	tŋuəc
ថ្ងេះ	tŋeh
ថ្ដោក	tɗaok
ថ្នក់	tnɑk
ថ្នល់	tnɑl
ថ្នាល	tnaal
ថ្នាស	tnaah
ថ្នាំ	tnam
ថ្និត	tnət
ថ្នឹក	tnək
ថ្នឹង	tnəŋ
ថ្នូរ	tnoo
ថ្នេរ	tnee
ថ្នោល	tnaol
ថ្ពក់	tpuək
ថ្ពិន	tpɨn
ថ្ពឹន	tpɨn
ថ្ពូត	tpuut
ថ្ពេច	tpeec
ថ្ពែក	tpɛɛk
ថ្មារ	tmaa
ថ្មើរ	tmaə
ថ្មោង	tmaoŋ
ថ្លង់	tlɑŋ
ថ្លាង	tlaaŋ
ថ្លឹង	tləŋ
ថ្លុក	tlok
ថ្លើង	tlaəŋ
ថ្លើម	tlaəm
ថ្លែង	tlaeŋ
ថ្លែន	tlaen
ថ្លោស	tlaoh
ថ្លោះ	tlɑh
ថ្វាក	twaak
ថ្វាង	twaaŋ
ថ្វាយ	twaaj
ថ្វិច	twəc
ថ្វឺយ	twəəj
ទង្គើ	tuŋ\.kəə
ទង្គះ	tuŋ\.keah
ទទាក់	tɔ\.teak
ទទ្រត	tɔ\.trɔɔt
ទទ្រប	tɔ\.trɔɔp
ទទ្រម	tɔ\.trɔɔm
ទធាក់	tɔ\.tʰeak
ទន្ទប	tun\.tɔɔp
ទន្លា	tun\.lie
ទន្លេ	tun\.lee
ទន្សង	tun\.sɑɑŋ
ទន្សា	tun\.saa
ទន្សែ	tun\.sae
ទម្រម	tum\.rɔɔm
ទំនញ់	tum\.nuɲ
ទំនន់	tum\.nun
ទំនប់	tum\.nup
ទំនាញ	tum\.nieɲ
ទំនាប	tum\.niep
ទំនាយ	tum\.niej
ទំនិញ	tum\.nɨɲ
ទំនឹម	tum\.nɨm
ទំនុក	tum\.nuk
ទំនូល	tum\.nuul
ទំនួញ	tum\.nuəɲ
ទំនួល	tum\.nuəl
ទំនើង	tum\.nəəŋ
ទំនើប	tum\.nəəp
ទំនើរ	tum\.nəə
ទំនើស	tum\.nəəh
ទំនៀប	tum\.niəp
ទំនៀម	tum\.niəm
ទំនេរ	tum\.nee
ទំពុន	tum\.pun
ទំពូង	tum\.puuŋ
ទំពួន	tum\.puən
ទំពែក	tum\.pɛɛk
ទំពោះ	tum\.puəh
ទំហឹង	tum\.həŋ
ទំហួន	tum\.huən
ទំហេង	tum\.heeŋ
ទំហែង	tum\.haeŋ
ទ្រង់	truŋ
ទ្រនំ	trɔ\.num
ទ្រពង	trɔ\.pɔɔŋ
ទ្រមម	trɔ\.mɔɔm
ទ្រមើ	trɔ\.məə
ទ្រមែ	trɔ\.mɛɛ
ទ្រយន	trɔ\.jɔɔn
ទ្រលូ	trɔ\.luu
ទ្រវះ	trɔ\.weah
ទ្រហោ	trɔ\.hao
ទ្រាប	triep
ទ្រាយ	triej
ទ្រាល	triel
ទ្រាស	trieh
ទ្រាំ	troam
ទ្រឹង	trɨŋ
ទ្រុង	truŋ
ទ្រុប	trup
ទ្រុយ	truj
ទ្រុល	trul
ទ្រូង	truuŋ
ទ្រួក	truək
ទ្រួស	truəh
ទ្រើង	trəəŋ
ទ្រើត	trəət
ទ្រើស	trəəh
ទ្រៀក	triək
ទ្រៀល	triəl
ទ្រៀស	triəh
ទ្រេត	treet
ទ្រេល	treel
ទ្រែម	trɛɛm
ទ្រោប	troop
ទ្រោម	troom
ទ្រោល	trool
ធ្ងន់	tŋun
ធ្ងាង	tŋieŋ
ធ្ងើង	tŋəəŋ
ធ្ងើល	tŋəəl
ធ្ងោង	tŋooŋ
ធ្ងោល	tŋool
ធ្នង់	tnuŋ
ធ្នល់	tnul
ធ្នស់	tnuəh
ធ្នារ	tnie
ធ្និម	tnɨm
ធ្នឹម	tnɨm
ធ្នើរ	tnəə
ធ្មង់	tmuŋ
ធ្មត់	tmut
ធ្មប់	tmup
ធ្មឹង	tmɨŋ
ធ្មុង	tmuŋ
ធ្មើង	tməəŋ
ធ្មេច	tmeec
ធ្មេញ	tmeeɲ
ធ្មោង	tmooŋ
ធ្យាន	tjien
ធ្យូង	tjuuŋ
ធ្លាយ	tliej
ធ្លីង	tliiŋ
ធ្លុង	tluŋ
ធ្លុញ	tluɲ
ធ្លុះ	tluh
ធ្លូញ	tluuɲ
ធ្លួង	tluəŋ
ធ្លែរ	tlɛɛ
ធ្លោយ	tlooj
ធ្វេស	tweeh
ន្រាយ	nriej
បង្កក	ɓɑŋ\.kɑɑk
បង្កង	ɓɑŋ\.kɑɑŋ
បង្កៃ	ɓɑŋ\.kaj
បង្ខក	ɓɑŋ\.kʰɑɑk
បង្ខន	ɓɑŋ\.kʰɑɑn
បង្ខំ	ɓɑŋ\.kʰɑm
បង្ខះ	ɓɑŋ\.kʰah
បង្គង	ɓɑŋ\.kɔɔŋ
បង្គរ	ɓɑŋ\.kɔɔ
បង្គា	ɓɑŋ\.kie
បង្គី	ɓɑŋ\.kii
បង្គៅ	ɓɑŋ\.kɨw
បង្គំ	ɓɑŋ\.kum
បង្រះ	ɓɑŋ\.rah
បង្ហក	ɓɑŋ\.hɑɑk
បង្ហប	ɓɑŋ\.hɑɑp
បង្ហា	ɓɑŋ\.haa
បង្ហែ	ɓɑŋ\.hae
បង្អក	ɓɑŋ\.ʔɑɑk
បង្អរ	ɓɑŋ\.ʔɑɑ
បង្អែ	ɓɑŋ\.ʔae
បង្អៅ	ɓɑŋ\.ʔaw
បញ្ចរ	ɓɑɲ\.cɑɑ
បញ្ចា	ɓɑɲ\.caa
បញ្ចើ	ɓɑɲ\.caə
បញ្ជត	ɓɑɲ\.cɔɔt
បញ្ជា	ɓɑɲ\.cie
បញ្ឈរ	ɓɑɲ\.cʰɔɔ
បញ្ឈឺ	ɓɑɲ\.cʰɨɨ
បញ្ញើ	ɓɑɲ\.ɲaə
បញ្ញែ	ɓɑɲ\.ɲae
បណ្ដា	ɓɑn\.ɗaa
បណ្ដៅ	ɓɑn\.ɗaw
បណ្ណែ	ɓɑn\.nae
បន្តម	ɓɑn\.tɑɑm
បន្ថត	ɓɑn\.tʰɑɑt
បន្ថយ	ɓɑn\.tʰɑɑj
បន្ថែ	ɓɑn\.tʰae
បន្ទរ	ɓɑn\.tɔɔ
បន្ទោ	ɓɑn\.too
បន្ទំ	ɓɑn\.tum
បន្ទះ	ɓɑn\.teah
បន្ធំ	ɓɑn\.tʰum
បន្លា	ɓɑn\.laa
បន្លឺ	ɓɑn\.ləə
បន្លែ	ɓɑn\.lae
បន្លំ	ɓɑn\.lɑm
បន្សះ	ɓɑn\.sah
បម្រើ	ɓɑm\.raə
បម្រះ	ɓɑm\.rah
បំណន់	ɓɑm\.nɑn
បំណាំ	ɓɑm\.nam
បំណិទ	ɓɑm\.nət
បំណុល	ɓɑm\.nol
បំណើក	ɓɑm\.naək
បំណែក	ɓɑm\.naek
បំណោក	ɓɑm\.naok
បំបង់	ɓɑm\.ɓɑŋ
បំបត់	ɓɑm\.ɓɑt
បំបាន	ɓɑm\.ɓaan
បំបិទ	ɓɑm\.ɓət
បំបួស	ɓɑm\.ɓuəh
បំបៀត	ɓɑm\.ɓiət
បំបែក	ɓɑm\.ɓaek
បំបែន	ɓɑm\.ɓaen
បំបែរ	ɓɑm\.ɓae
បំបោរ	ɓɑm\.ɓao
បំបោល	ɓɑm\.ɓaol
បំប៉ន	ɓɑm\.pɑɑn
បំប៉ះ	ɓɑm\.pah
បំផាយ	ɓɑm\.pʰaaj
បំផឹក	ɓɑm\.pʰək
បំផុង	ɓɑm\.pʰoŋ
បំផុត	ɓɑm\.pʰot
បំផុយ	ɓɑm\.pʰoj
បំផុល	ɓɑm\.pʰol
បំផុស	ɓɑm\.pʰoh
បំផូរ	ɓɑm\.pʰoo
បំផើម	ɓɑm\.pʰaəm
បំពក់	ɓɑm\.puək
បំពង់	ɓɑm\.puŋ
បំពត់	ɓɑm\.put
បំពាន	ɓɑm\.pien
បំពារ	ɓɑm\.pie
បំពាំ	ɓɑm\.poam
បំពុល	ɓɑm\.pul
បំពួន	ɓɑm\.puən
បំពើង	ɓɑm\.pəəŋ
បំពើត	ɓɑm\.pəət
បំពៀច	ɓɑm\.piəc
បំពេញ	ɓɑm\.peeɲ
បំពេន	ɓɑm\.peen
បំពោក	ɓɑm\.pook
បំពោត	ɓɑm\.poot
បំពោប	ɓɑm\.poop
បំពោរ	ɓɑm\.poo
បំភិត	ɓɑm\.pʰɨt
ប៉ប៉ក	pɑ\.pɑɑk
ប៉ប៉ៅ	pɑ\.paw
ប៉ប៉ះ	pɑ\.pah
ប៉ផង់	pɑ\.pʰɑŋ
ប៉ផាង	pɑ\.pʰaaŋ
ប៉ផុក	pɑ\.pʰok
ប៉ផុត	pɑ\.pʰot
ប៉ផូង	pɑ\.pʰooŋ
ប៉ផូរ	pɑ\.pʰoo
ប៉ផូស	pɑ\.pʰooh
ប៉ផែត	pɑ\.pʰaet
ប៉ាក់	pak
ប៉ាច់	pac
ប៉ាត់	pat
ប៉ាន់	pan
ប៉ាប់	pap
ប្ដឹង	pɗəŋ
ប្ដូរ	pɗoo
ប្រកប	prɑ\.kɑɑp
ប្រកា	prɑ\.kaa
ប្រកៃ	prɑ\.kaj
ប្រក់	prɑk
ប្រខង	prɑ\.kʰɑɑŋ
ប្រគង	prɑ\.kɔɔŋ
ប្រគរ	prɑ\.kɔɔ
ប្រគំ	prɑ\.kum
ប្រង់	prɑŋ
ប្រចច	prɑ\.cɑɑc
ប្រចី	prɑ\.cəj
ប្រចែ	prɑ\.cae
ប្រឈម	prɑ\.cʰɔɔm
ប្រដា	prɑ\.ɗaa
ប្រដែ	prɑ\.ɗae
ប្រដៅ	prɑ\.ɗaw
ប្រដំ	prɑ\.ɗɑm
ប្រណី	prɑ\.nəj
ប្រថម	prɑ\.tʰɑɑm
ប្រថំ	prɑ\.tʰɑm
ប្រទះ	prɑ\.teah
ប្រពៃ	prɑ\.pej
ប្រមេ	prɑ\.mee
ប្រមែ	prɑ\.mae
ប្រលង	prɑ\.lɑɑŋ
ប្រវា	prɑ\.waa
ប្រវេ	prɑ\.wee
ប្រសា	prɑ\.saa
ប្រស់	prɑh
ប្រហក	prɑ\.hɑɑk
ប្រឡង	prɑ\.lɑɑŋ
ប្រឡៅ	prɑ\.law
ប្រាប	praap
ប្រាម	praam
ប្រាយ	praaj
ប្រាវ	praaw
ប្រាស	praah
ប្រាំ	pram
ប្រិច	prəc
ប្រិញ	prəɲ
ប្រិត	prət
ប្រិប	prəp
ប្រិល	prəl
ប្រឹង	prəŋ
ប្រឹប	prəp
ប្រឹស	prəh
ប្រឹះ	prəh
ប្រុង	proŋ
ប្រុន	pron
ប្រុយ	proj
ប្រុះ	proh
ប្រូង	prooŋ
ប្រូច	prooc
ប្រូស	prooh
ប្រួក	pruək
ប្រួញ	pruəɲ
ប្រួត	pruət
ប្រួម	pruəm
ប្រួល	pruəl
ប្រើស	praəh
ប្រឿង	prɨəŋ
ប្រៀច	priəc
ប្រៀន	priən
ប្រៀប	priəp
ប្រេង	preeŋ
ប្រេវ	preew
ប្រេះ	preh
ប្រែក	praek
ប្រែង	praeŋ
ប្រែះ	praeh
ប្រោក	praok
ប្រោស	praoh
ប្រោះ	prɑh
ប្លក់	plɑk
ប្លន់	plɑn
ប្លប់	plɑp
ប្លាញ	plaaɲ
ប្លាប	plaap
ប្លាយ	plaaj
ប្លាំ	plam
ប្លិក	plək
ប្លិច	pləc
ប្លឹក	plək
ប្លឺម	pləəm
ប្លុក	plok
ប្លុង	ploŋ
ប្លូក	plook
ប្លូច	plooc
ប្លួក	pluək
ប្លើក	plaək
ប្លៀក	pliək
ប្លៀវ	pliəw
ប្លេង	pleeŋ
ប្លែក	plaek
ប្លែង	plaeŋ
ប្លែន	plaen
ប្លែម	plaem
ប្លោក	plaok
ប្លោង	plaoŋ
ប្លោញ	plaoɲ
ប្លោត	plaot
ប្អូន	pʔoon
ផ្កាយ	pkaaj
ផ្កាស	pkaah
ផ្គង់	pkuŋ
ផ្គត់	pkut
ផ្គាំ	pkoam
ផ្គុន	pkun
ផ្គុំ	pkum
ផ្គួប	pkuəp
ផ្គើន	pkəən
ផ្ងក់	pŋɑk
ផ្ងាក	pŋaak
ផ្ងារ	pŋaa
ផ្ងាវ	pŋaaw
ផ្ងុប	pŋop
ផ្ងូត	pŋoot
ផ្ងើយ	pŋaəj
ផ្ចង់	pcɑŋ
ផ្ចប់	pcɑp
ផ្ចាល	pcaal
ផ្ចិត	pcət
ផ្ចឹក	pcək
ផ្ចុក	pcok
ផ្ចុច	pcoc
ផ្ចោត	pcaot
ផ្ញាញ	pɲaaɲ
ផ្ញុក	pɲok
ផ្ញុច	pɲoc
ផ្ញៀវ	pɲiəw
ផ្ញោញ	pɲaoɲ
ផ្ដល់	pɗɑl
ផ្ដាស	pɗaah
ផ្ដាំ	pɗam
ផ្ដិត	pɗət
ផ្ដិល	pɗəl
ផ្ដឺត	pɗəət
ផ្ដុស	pɗoh
ផ្ដុំ	pɗom
ផ្ដូត	pɗoot
ផ្ដួច	pɗuəc
ផ្ដួល	pɗuəl
ផ្ដើម	pɗaəm
ផ្ដៀក	pɗiək
ផ្ដៀង	pɗiəŋ
ផ្ដៀច	pɗiəc
ផ្ដេក	pɗeek
ផ្ដេច	pɗeec
ផ្ដែក	pɗaek
ផ្ដែរ	pɗae
ផ្ដោត	pɗaot
ផ្ដោម	pɗaom
ផ្តក់	ptɑk
ផ្តត់	ptɑt
ផ្តិល	ptəl
ផ្តឹក	ptək
ផ្តើក	ptaək
ផ្តេត	pteet
ផ្ទក់	ptuək
ផ្ទញ់	ptuɲ
ផ្ទប់	ptup
ផ្ទល់	ptul
ផ្ទារ	ptie
ផ្ទាល	ptiel
ផ្ទីង	ptiiŋ
ផ្ទឹម	ptɨm
ផ្ទុក	ptuk
ផ្ទុយ	ptuj
ផ្ទុរ	ptu
ផ្ទូរ	ptuu
ផ្ទួន	ptuən
ផ្ទៀង	ptiəŋ
ផ្ទេរ	ptee
ផ្ទោង	ptooŋ
ផ្ទោល	ptool
ផ្នង់	pnɑŋ
ផ្នត់	pnɑt
ផ្នាល	pnaal
ផ្នូត	pnoot
ផ្នូរ	pnoo
ផ្នូល	pnool
ផ្នួង	pnuəŋ
ផ្នួស	pnuəh
ផ្នៀង	pniəŋ
ផ្នៀរ	pniə
ផ្នែក	pnaek
ផ្នែល	pnael
ផ្នោល	pnaol
ផ្នោះ	pnɑh
ផ្លប់	plɑp
ផ្លាង	plaaŋ
ផ្លាញ	plaaɲ
ផ្លាន	plaan
ផ្លិត	plət
ផ្លុំ	plom
ផ្លូច	plooc
ផ្លូន	ploon
ផ្លូវ	ploow
ផ្លួក	pluək
ផ្លួត	pluət
ផ្លើស	plaəh
ផ្លៀក	pliək
ផ្លេក	pleek
ផ្លែង	plaeŋ
ផ្លោង	plaoŋ
ផ្លោត	plaot
ផ្លោះ	plɑh
ផ្សាយ	psaaj
ផ្សារ	psaa
ផ្សាំ	psam
ផ្សិង	psəŋ
ផ្សិត	psət
ផ្សឹក	psək
ផ្សើម	psaəm
ផ្សេង	pseeŋ
ផ្សែង	psaeŋ
ផ្សែត	psaet
ផ្សោត	psaot
ផ្សោះ	psɑh
ផ្អាក	pʔaak
ផ្អាវ	pʔaaw
ផ្អឹក	pʔək
ផ្អឹប	pʔəp
ផ្អឹះ	pʔəh
ផ្អឺប	pʔəəp
ផ្អុក	pʔok
ផ្អុង	pʔoŋ
ផ្អុច	pʔoc
ផ្អូក	pʔook
ផ្អូច	pʔooc
ផ្អូម	pʔoom
ផ្អួរ	pʔuə
ផ្អួស	pʔuəh
ផ្អើល	pʔaəl
ផ្អើះ	pʔaəh
ផ្អៀង	pʔiəŋ
ផ្អេះ	pʔeh
ផ្អែក	pʔaek
ផ្អែប	pʔaep
ផ្អែម	pʔaem
ផ្អោង	pʔaoŋ
ផ្អោប	pʔaop
ផ្អោះ	pʔɑh
ពង្រន	puŋ\.rɔɔn
ពង្រល	puŋ\.rɔɔl
ពង្រា	puŋ\.rie
ពង្រេ	puŋ\.ree
ពន្យី	pun\.jii
ពន្យើ	pun\.jəə
ពន្យះ	pun\.jeah
ពន្លក	pun\.lɔɔk
ពន្លា	pun\.lie
ពន្លឺ	pun\.lɨɨ
ពន្លៃ	pun\.lej
ពន្លះ	pun\.leah
ពពាក់	pɔ\.peak
ពព្រត	pɔ\.prɔɔt
ពព្រល	pɔ\.prɔɔl
ពភ្លន	pɔ\.plɔɔn
ពភ្លា	pɔ\.plie
ពភ្លើ	pɔ\.pləə
ពំនត់	pum\.nut
ពំនិត	pum\.nɨt
ពំនឹង	pum\.nɨŋ
ពំនូក	pum\.nuuk
ពំនូត	pum\.nuut
ពំនូន	pum\.nuun
ពំនួត	pum\.nuət
ពំនៀរ	pum\.niə
ពំនោល	pum\.nool
ពំឡើង	pum\.laəŋ
ព្នាយ	pniej
ព្និល	pnɨl
ព្នៀត	pniət
ព្យុះ	pjuh
ព្យួរ	pjuə
ព្រង់	pruŋ
ព្រនម	prɔ\.nɔɔm
ព្រនរ	prɔ\.nɔɔ
ព្រមរ	prɔ\.mɔɔ
ព្រលយ	prɔ\.lɔɔj
ព្រលះ	prɔ\.leah
ព្រាង	prieŋ
ព្រាច	priec
ព្រាន	prien
ព្រាប	priep
ព្រាម	priem
ព្រាយ	priej
ព្រាល	priel
ព្រាវ	priew
ព្រាំ	proam
ព្រិច	prɨc
ព្រិញ	prɨɲ
ព្រិល	prɨl
ព្រីក	priik
ព្រីង	priiŋ
ព្រឹក	prɨk
ព្រឹប	prɨp
ព្រឹម	prɨm
ព្រឹល	prɨl
ព្រឺស	prɨɨh
ព្រឺះ	prɨɨh
ព្រុក	pruk
ព្រុយ	pruj
ព្រុល	prul
ព្រូត	pruut
ព្រូន	pruun
ព្រូស	pruuh
ព្រួក	pruək
ព្រួច	pruəc
ព្រួញ	pruəɲ
ព្រួត	pruət
ព្រួម	pruəm
ព្រួយ	pruəj
ព្រួល	pruəl
ព្រួស	pruəh
ព្រើត	prəət
ព្រើម	prəəm
ព្រើល	prəəl
ព្រើស	prəəh
ព្រៀច	priəc
ព្រៀប	priəp
ព្រេង	preeŋ
ព្រេច	preec
ព្រេន	preen
ព្រែក	prɛɛk
ព្រែល	prɛɛl
ព្រោក	prook
ព្រោង	prooŋ
ព្រោន	proon
ព្រោះ	pruəh
ព្លុក	pluk
ព្លែម	plɛɛm
ភក្ដិ	pʰɔ\.kɗeʔ
ភង្គី	pʰuŋ\.kii
ភស្តុ	pʰɔ\.stoʔ
ភ្ងក់	pŋuək
ភ្ងប់	pŋup
ភ្ងារ	pŋie
ភ្ងាស	pŋieh
ភ្ងូត	pŋuut
ភ្ងើក	pŋəək
ភ្ងើយ	pŋəəj
ភ្ជង់	pcuŋ
ភ្ជល់	pcul
ភ្ជាំ	pcoam
ភ្ជិត	pcɨt
ភ្ជុំ	pcum
ភ្ជួរ	pcuə
ភ្ជើញ	pcəəɲ
ភ្ជោក	pcook
ភ្ញច់	pɲuc
ភ្ញល់	pɲul
ភ្ញៀវ	pɲiəw
ភ្នក់	pnuək
ភ្នាន	pnien
ភ្នាស	pnieh
ភ្នាំ	pnoam
ភ្នើន	pnəən
ភ្នេន	pneen
ភ្នែក	pnɛɛk
ភ្នែន	pnɛɛn
ភ្នែល	pnɛɛl
ភ្មាស	pmieh
ភ្រុស	pruh
ភ្លាង	plieŋ
ភ្លាម	pliem
ភ្លាវ	pliew
ភ្លឹក	plɨk
ភ្លឹង	plɨŋ
ភ្លឹប	plɨp
ភ្លឹម	plɨm
ភ្លឹះ	plɨh
ភ្លុក	pluk
ភ្លុង	pluŋ
ភ្លូក	pluuk
ភ្លូច	pluuc
ភ្លួត	pluət
ភ្លើក	pləək
ភ្លើង	pləəŋ
ភ្លើន	pləən
ភ្លើយ	pləəj
ភ្លៀក	pliək
ភ្លៀង	pliəŋ
ភ្លេង	pleeŋ
ភ្លេច	pleec
ភ្លែត	plɛɛt
ភ្លែម	plɛɛm
ភ្លែល	plɛɛl
ភ្លោះ	pluəh
ភ្សាំ	psoam
ម៉ាក់	mak
ម៉ាច់	mac
ម៉ាត់	mat
ម៉ាំង	maŋ
ម្កាល	mkaal
ម្ខាង	mkʰaaŋ
ម្ង៉ៃ	mŋaj
ម្ចត់	mcɑt
ម្ចាន	mcaan
ម្ជុល	mcul
ម្ជូរ	mcuu
ម្ដាយ	mɗaaj
ម្ដុំ	mɗom
ម្ដេច	mɗeec
ម្ទេស	mteeh
ម្នាង	mnieŋ
ម្នាល	mniel
ម្និល	mnɨl
ម្នេញ	mneeɲ
ម្យប់	mjup
ម្យាម	mjiem
ម្រាម	mriem
ម្រីក	mriik
ម្រុម	mrum
ម្រុំ	mrum
ម្រេញ	mreeɲ
ម្រែង	mrɛɛŋ
ម្រោម	mroom
ម្លប់	mlup
ម្លាយ	mliej
ម្លឺត	mlɨɨt
ម្សិល	msəl
ម្សៀត	msiət
ម្សេវ	mseew
ម្ហូប	mhoop
ម្ហើប	mhaəp
ម្ហេប	mheep
ម្ហេះ	mheh
យក្សា	jɔ\.ksaa
យក្សី	jɔ\.ksəj
យ៉ាប់	jap
រគាំង	rɔ\.keaŋ
រឃាំង	rɔ\.kʰeaŋ
រងាក់	rɔ\.ŋeak
រងាន់	rɔ\.ŋoan
រងាប់	rɔ\.ŋoap
រង៉ឺត	rɔ\.ŋəət
រង៉ូវ	rɔ\.ŋoow
រង៉ោម	rɔ\.ŋaom
រង្គើ	ruŋ\.kəə
រង្គំ	ruŋ\.kum
រង្វះ	ruŋ\.weah
រញ៉ាំ	rɔ\.ɲam
រញ៉ិម	rɔ\.ɲəm
រញ៉ិល	rɔ\.ɲəl
រដាក់	rɔ\.ɗak
រដាច់	rɔ\.ɗac
រណ្ដៅ	run\.ɗaw
រណ្ដំ	run\.ɗɑm
រតាត់	rɔ\.tat
រត្នា	rɔ\.tnaa
រទាំង	rɔ\.teaŋ
រនាស់	rɔ\.noah
រនាំង	rɔ\.neaŋ
រន្ទា	run\.tie
រន្ទឺ	run\.tɨɨ
រន្ទះ	run\.teah
របាំង	rɔ\.ɓaŋ
រប៉ាយ	rɔ\.paaj
រប៉ោយ	rɔ\.paoj
រពាក់	rɔ\.peak
រមាត់	rɔ\.moat
រមាស់	rɔ\.moah
រមាំង	rɔ\.meaŋ
រម៉ង់	rɔ\.mɑŋ
រម៉ិង	rɔ\.məŋ
រម៉ឹម	rɔ\.məm
រម៉ោក	rɔ\.maok
រម្ងក	rum\.ŋɔɔk
រម្លំ	rum\.lum
រម្ហែ	rum\.hae
រម្អា	rum\.ʔaa
រយ៉ិល	rɔ\.jəl
រលាក់	rɔ\.leak
រលាត់	rɔ\.loat
រលាស់	rɔ\.loah
រលាំង	rɔ\.leaŋ
រវាន់	rɔ\.woan
រវាំង	rɔ\.weaŋ
រវ៉ក់	rɔ\.wɑk
រវ៉ិក	rɔ\.wək
រវ៉ូស	rɔ\.wooh
រវ៉ើក	rɔ\.waək
រវ៉ោច	rɔ\.waoc
រវ៉ោប	rɔ\.waop
រសាត់	rɔ\.sat
រស្មី	rɔ\.sməj
រហាក់	rɔ\.hak
រហាត់	rɔ\.hat
រហាល់	rɔ\.hal
រហ៊ិះ	rɔ\.hih
រហ៊ឹម	rɔ\.hɨm
រហ៊ឹះ	rɔ\.hɨh
រហ៊ុម	rɔ\.hum
រហ៊ុះ	rɔ\.huh
រឡាក់	rɔ\.lak
រអ៊ុះ	rɔ\.ʔuh
រំកិល	rum\.kəl
រំខាន	rum\.kʰaan
រំគាយ	rum\.kiej
រំគាល	rum\.kiel
រំគេញ	rum\.keeɲ
រំងាច	rum\.ŋiec
រំងើក	rum\.ŋəək
រំចាក	rum\.caak
រំចេក	rum\.ceek
រំជីក	rum\.ciik
រំជួល	rum\.cuəl
រំជើប	rum\.cəəp
រំជេញ	rum\.ceeɲ
រំជែក	rum\.cɛɛk
រំដាក	rum\.ɗaak
រំដួល	rum\.ɗuəl
រំដេក	rum\.ɗeek
រំដេង	rum\.ɗeeŋ
រំដេញ	rum\.ɗeeɲ
រំដោះ	rum\.ɗɑh
រំបល់	rum\.ɓɑl
រំពត់	rum\.put
រំពឹង	rum\.pɨŋ
រំពុះ	rum\.puh
រំពើក	rum\.pəək
រំពើន	rum\.pəən
រំពេច	rum\.peec
រំពេន	rum\.peen
រំភាយ	rum\.pʰiej
រំភើក	rum\.pʰəək
រំភើប	rum\.pʰəəp
រំភើយ	rum\.pʰəəj
រំយាក	rum\.jiek
រំយីក	rum\.jiik
រំយោល	rum\.jool
រំលត់	rum\.lut
រំលប់	rum\.lup
រំលស់	rum\.luəh
រំលាក	rum\.liek
រំលាង	rum\.lieŋ
រំលាយ	rum\.liej
រំលិច	rum\.lɨc
រំលីង	rum\.liiŋ
រំលឹក	rum\.lɨk
រំលុង	rum\.luŋ
រំលុប	rum\.lup
រំលុះ	rum\.luh
រំលូត	rum\.luut
រំលើក	rum\.ləək
រំលើង	rum\.ləəŋ
រំលៀក	rum\.liək
រំលៀង	rum\.liəŋ
រំលេច	rum\.leec
រំលេប	rum\.leep
រំលេម	rum\.leem
រំលេះ	rum\.leh
រំលែក	rum\.lɛɛk
រំលែះ	rum\.lɛh
រំលោក	rum\.look
រំលោង	rum\.looŋ
រំលោភ	rum\.loopʰ
រំសាយ	rum\.saaj
រំសុស	rum\.soh
រំសេវ	rum\.seew
រំសោះ	rum\.sɑh
រំហាច	rum\.haac
រំហុក	rum\.hok
រំហូត	rum\.hoot
រំហូរ	rum\.hoo
រំហួត	rum\.huət
រំហើយ	rum\.haəj
រំហោក	rum\.haok
រំអិល	rum\.ʔəl
រំអុក	rum\.ʔok
រំអួយ	rum\.ʔuəj
រំអើក	rum\.ʔaək
រំអែង	rum\.ʔaeŋ
រ៉ាត់	rat
រ៉ាប់	rap
លន្តែ	lun\.tae
លម្ហែ	lum\.hae
លម្អង	lum\.ʔɑɑŋ
លំគេញ	lum\.keeɲ
លំចង់	lum\.cɑŋ
លំដោយ	lum\.ɗaoj
លំទោន	lum\.toon
លំនាច	lum\.niec
លំនាំ	lum\.noam
លំនឹង	lum\.nɨŋ
លំបាក	lum\.ɓaak
លំបិន	lum\.ɓən
លំបេក	lum\.ɓeek
លំប៉ា	lum\.paa
លំផូង	lum\.pʰooŋ
លំពង់	lum\.puŋ
លំពស់	lum\.puəh
លំពើន	lum\.pəən
លំពែង	lum\.pɛɛŋ
លំហាច	lum\.haac
លំហុក	lum\.hok
លំហួត	lum\.huət
លំហើយ	lum\.haəj
លំហោក	lum\.haok
លំអក់	lum\.ʔɑk
លំអន់	lum\.ʔɑn
លំអិត	lum\.ʔət
លំអុត	lum\.ʔot
លំអូត	lum\.ʔoot
លំអៀង	lum\.ʔiəŋ
ល្កក់	lkɑk
ល្ខោន	lkʰaon
ល្គាយ	lkiej
ល្គឹក	lkɨk
ល្គេន	lkeen
ល្ងង់	lŋuŋ
ល្ងាច	lŋiec
ល្ងៀង	lŋiəŋ
ល្ងៀម	lŋiəm
ល្បក់	lɓɑk
ល្បត់	lɓɑt
ល្បប់	lɓɑp
ល្បាញ	lɓaaɲ
ល្បាត	lɓaat
ល្បាយ	lɓaaj
ល្បិច	lɓəc
ល្បុង	lɓoŋ
ល្បួង	lɓuəŋ
ល្បើក	lɓaək
ល្បឿន	lɓɨən
ល្បែង	lɓaeŋ
ល្បោយ	lɓaoj
ល្បោះ	lɓɑh
ល្មាស	lmieh
ល្មិច	lmɨc
ល្មុង	lmuŋ
ល្មុត	lmut
ល្មូន	lmuun
ល្មួច	lmuəc
ល្មួត	lmuət
ល្មើស	lməəh
ល្មឿង	lmɨəŋ
ល្មឿយ	lmɨəj
ល្មៀត	lmiət
ល្មេច	lmeec
ល្មែះ	lmɛh
ល្មោភ	lmoopʰ
ល្ម៉ើ	lmaə
ល្វក់	lwuək
ល្វន់	lwun
ល្វីង	lwiiŋ
ល្វឹង	lwɨŋ
ល្វើយ	lwəəj
ល្វៀង	lwiəŋ
ល្វែង	lwɛɛŋ
ល្វែត	lwɛɛt
ល្ហក់	lhɑk
ល្ហាច	lhaac
ល្ហាល	lhaal
ល្ហឹម	lhəm
ល្ហុង	lhoŋ
ល្ហួត	lhuət
ល្ហើយ	lhaəj
ល្ហេវ	lheew
ល្ហែម	lhaem
ល្ហោល	lhaol
ល្ហោស	lhaoh
ល្អក់	lʔɑk
ល្អន់	lʔɑn
ល្អាង	lʔaaŋ
ល្អាត	lʔaat
ល្អាន	lʔaan
ល្អិត	lʔət
ល្អិន	lʔən
ល្អូក	lʔook
ល្អូត	lʔoot
ល្អួត	lʔuət
ល្អៀង	lʔiəŋ
ល្អៀច	lʔiəc
ល្អោច	lʔaoc
ល្អោញ	lʔaoɲ
ល្អោម	lʔaom
វ៉ាប់	wap
វ៉ាល់	wal
វ្ហើយ	whaəj
សង្កែ	sɑŋ\.kae
សង្ឃក	sɑŋ\.kʰɔɔk
សង្ឃា	sɑŋ\.kʰie
សង្រៃ	sɑŋ\.raj
សង្ហា	sɑŋ\.haa
សច្ចា	sɑ\.ccaa
សណ្ដក	sɑn\.ɗɑɑk
សណ្ដា	sɑn\.ɗaa
សណ្ដំ	sɑn\.ɗɑm
សត្យា	sɑ\.tjaa
សត្រី	sɑ\.trəj
សត្វា	sɑ\.twaa
សន្ទៃ	sɑn\.tej
សន្ទះ	sɑn\.teah
សន្ធិ	sɑn\.tʰiʔ
សន្ធៃ	sɑn\.tʰej
សន្ធោ	sɑn\.tʰoo
សន្ធៅ	sɑn\.tʰɨw
សន្ធំ	sɑn\.tʰum
សន្យា	sɑn\.jaa
សន្សែ	sɑn\.sae
សន្សំ	sɑn\.sɑm
សម្កក	sɑm\.kɑɑk
សម្គម	sɑm\.kɔɔm
សម្ងំ	sɑm\.ŋɑm
សម្ដី	sɑm\.ɗəj
សម្តត	sɑm\.tɑɑt
សម្ទល	sɑm\.tɔɔl
សម្បក	sɑm\.ɓɑɑk
សម្បថ	sɑm\.ɓɑɑtʰ
សម្បា	sɑm\.ɓaa
សម្មត	sɑm\.mɑɑt
សម្រក	sɑm\.rɑɑk
សម្រប	sɑm\.rɑɑp
សម្លប	sɑm\.lɑɑp
សម្អក	sɑm\.ʔɑɑk
សស្លោ	sɑ\.slao
សំកាក	sɑm\.kaak
សំកុក	sɑm\.kok
សំកុង	sɑm\.koŋ
សំកុល	sɑm\.kol
សំកូញ	sɑm\.kooɲ
សំកូវ	sɑm\.koow
សំកេក	sɑm\.keek
សំកោក	sɑm\.kaok
សំគិស	sɑm\.kih
សំគីម	sɑm\.kiim
សំគុល	sɑm\.kul
សំគែម	sɑm\.kɛɛm
សំគោក	sɑm\.kook
សំងាច	sɑm\.ŋaac
សំងើច	sɑm\.ŋaəc
សំដិល	sɑm\.ɗəl
សំដឹង	sɑm\.ɗəŋ
សំដឺត	sɑm\.ɗəət
សំដើង	sɑm\.ɗaəŋ
សំដែង	sɑm\.ɗaeŋ
សំដោះ	sɑm\.ɗɑh
សំណង់	sɑm\.nɑŋ
សំណល់	sɑm\.nɑl
សំណាក	sɑm\.naak
សំណាង	sɑm\.naaŋ
សំណាញ	sɑm\.naaɲ
សំណាប	sɑm\.naap
សំណាម	sɑm\.naam
សំណិង	sɑm\.nəŋ
សំណឹក	sɑm\.nək
សំណុស	sɑm\.noh
សំណុំ	sɑm\.nom
សំណុះ	sɑm\.noh
សំណូក	sɑm\.nook
សំណូម	sɑm\.noom
សំណួរ	sɑm\.nuə
សំណើច	sɑm\.naəc
សំណើម	sɑm\.naəm
សំណេះ	sɑm\.neh
សំណែន	sɑm\.naen
សំណែព	sɑm\.naep
សំណែស	sɑm\.naeh
សំណោក	sɑm\.naok
សំតុល	sɑm\.tol
សំតេត	sɑm\.teet
សំតែក	sɑm\.taek
សំតោក	sɑm\.taok
សំទក់	sɑm\.tuək
សំទង់	sɑm\.tuŋ
សំទាញ	sɑm\.tieɲ
សំទារ	sɑm\.tie
សំទីក	sɑm\.tiik
សំទុះ	sɑm\.tuh
សំទូង	sɑm\.tuuŋ
សំទើញ	sɑm\.təəɲ
សំទេះ	sɑm\.teh
សំទែល	sɑm\.tɛɛl
សំទែះ	sɑm\.tɛh
សំនឹក	sɑm\.nək
សំនួន	sɑm\.nuən
សំនៀង	sɑm\.niəŋ
សំបារ	sɑm\.ɓaa
សំបុក	sɑm\.ɓok
សំបួរ	sɑm\.ɓuə
សំបែង	sɑm\.ɓaeŋ
សំបោរ	sɑm\.ɓao
សំផិង	sɑm\.pʰəŋ
សំពង់	sɑm\.puŋ
សំពត់	sɑm\.put
សំពាយ	sɑm\.piej
សំពិន	sɑm\.pɨn
សំពីង	sɑm\.piiŋ
សំពឹក	sɑm\.pɨk
សំពុង	sɑm\.puŋ
សំពៀត	sɑm\.piət
សំពេះ	sɑm\.peh
សំពែះ	sɑm\.pɛh
សំពោង	sɑm\.pooŋ
សំពោច	sɑm\.pooc
សំភោរ	sɑm\.pʰoo
សំយាក	sɑm\.jaak
សំយាប	sɑm\.jaap
សំយាយ	sɑm\.jaaj
សំយុង	sɑm\.joŋ
សំយេះ	sɑm\.jeh
សំរាជ	sɑm\.raac
សំរាម	sɑm\.raam
សំរុង	sɑm\.roŋ
សំរូប	sɑm\.roop
សំរៀម	sɑm\.riəm
សំរោង	sɑm\.raoŋ
សំលៀង	sɑm\.liəŋ
សំវាស	sɑm\.waah
សំវេគ	sɑm\.week
សំសារ	sɑm\.saa
សំឡាញ	sɑm\.laaɲ
សំឡេង	sɑm\.leeŋ
សំឡេះ	sɑm\.leh
សំឡែះ	sɑm\.laeh
សំអប់	sɑm\.ʔɑp
សំអាង	sɑm\.ʔaaŋ
សំអាត	sɑm\.ʔaat
សំអិត	sɑm\.ʔət
សំអុយ	sɑm\.ʔoj
សំអុះ	sɑm\.ʔoh
សំអេក	sɑm\.ʔeek
សំអែក	sɑm\.ʔaek
សំអែល	sɑm\.ʔael
សំអោក	sɑm\.ʔaok
ស្កប់	skɑp
ស្កល់	skɑl
ស្កាក	skaak
ស្កាញ	skaaɲ
ស្កាត	skaat
ស្ការ	skaa
ស្កាល	skaal
ស្កាំ	skam
ស្កិល	skəl
ស្កុង	skoŋ
ស្កុន	skon
ស្កុយ	skoj
ស្កុល	skol
ស្កូញ	skooɲ
ស្កូវ	skoow
ស្កួយ	skuəj
ស្កើក	skaək
ស្កៀប	skiəp
ស្គន់	skun
ស្គាយ	skiej
ស្គារ	skie
ស្គឹះ	skɨh
ស្គុយ	skuj
ស្គុល	skul
ស្គុស	skuh
ស្គុះ	skuh
ស្គួយ	skuəj
ស្គោក	skook
ស្ងប់	sŋɑp
ស្ងាច	sŋaac
ស្ងាប	sŋaap
ស្ងួត	sŋuət
ស្ងួន	sŋuən
ស្ងើក	sŋaək
ស្ងើច	sŋaəc
ស្ងើន	sŋaən
ស្ងៀម	sŋiəm
ស្ងោរ	sŋao
ស្ញក់	sɲɑk
ស្ញប់	sɲɑp
ស្ញាញ	sɲaaɲ
ស្ញិញ	sɲəɲ
ស្ញុក	sɲok
ស្ញុរ	sɲo
ស្ញូញ	sɲooɲ
ស្ញើប	sɲaəp
ស្ញេញ	sɲeeɲ
ស្ញែង	sɲaeŋ
ស្ញោរ	sɲao
ស្ដាយ	sɗaaj
ស្ដារ	sɗaa
ស្ដាំ	sɗam
ស្ដឹង	sɗəŋ
ស្ដឺត	sɗəət
ស្ដុក	sɗok
ស្ដូក	sɗook
ស្ដួច	sɗuəc
ស្ដើង	sɗaəŋ
ស្ដៀង	sɗiəŋ
ស្ដៀន	sɗiən
ស្ដេច	sɗeec
ស្ដែង	sɗaeŋ
ស្ដោះ	sɗɑh
ស្តឹក	stək
ស្តុក	stok
ស្តុល	stol
ស្តេត	steet
ស្តែក	staek
ស្តែត	staet
ស្តោក	staok
ស្ទក់	stuək
ស្ទង់	stuŋ
ស្ទន់	stun
ស្ទប់	stup
ស្ទល់	stul
ស្ទាញ	stieɲ
ស្ទាប	stiep
ស្ទាវ	stiew
ស្ទិល	stɨl
ស្ទីក	stiik
ស្ទឹង	stɨŋ
ស្ទឹម	stɨm
ស្ទឹល	stɨl
ស្ទុង	stuŋ
ស្ទុយ	stuj
ស្ទុល	stul
ស្ទុះ	stuh
ស្ទូង	stuuŋ
ស្ទូច	stuuc
ស្ទូរ	stuu
ស្ទួន	stuən
ស្ទួយ	stuəj
ស្ទើង	stəəŋ
ស្ទើញ	stəəɲ
ស្ទើត	stəət
ស្ទើរ	stəə
ស្ទៀង	stiəŋ
ស្ទេង	steeŋ
ស្ទេញ	steeɲ
ស្ទេះ	steh
ស្ទែត	stɛɛt
ស្ទែល	stɛɛl
ស្ទែះ	stɛh
ស្ទោក	stook
ស្ទោង	stooŋ
ស្ទោះ	stuəh
ស្នប់	snɑp
ស្នាច	snaac
ស្នាប	snaap
ស្នាម	snaam
ស្នាយ	snaaj
ស្នាល	snaal
ស្និត	snət
ស្និម	snəm
ស្នឹង	snəŋ
ស្នុំ	snom
ស្នូក	snook
ស្នូរ	snoo
ស្នូល	snool
ស្នួល	snuəl
ស្នៀត	sniət
ស្នែង	snaeŋ
ស្បង់	sɓɑŋ
ស្បាត	sɓaat
ស្បិត	sɓət
ស្បឺត	sɓəət
ស្បុរ	sɓo
ស្បូន	sɓoon
ស្បូវ	sɓoow
ស្បើម	sɓaəm
ស្បើយ	sɓaəj
ស្បៀង	sɓiəŋ
ស្បេត	sɓeet
ស្បែក	sɓaek
ស្បែង	sɓaeŋ
ស្បែប	sɓaep
ស្បោង	sɓaoŋ
ស្ប៉ត	spɑɑt
ស្ពង់	spuŋ
ស្ពាន	spien
ស្ពាយ	spiej
ស្ពីង	spiiŋ
ស្ពឹក	spɨk
ស្ពឹង	spɨŋ
ស្ពុច	spuc
ស្ពុយ	spuj
ស្ពុរ	spu
ស្ពើន	spəən
ស្ពៀត	spiət
ស្ពេះ	speh
ស្ពែត	spɛɛt
ស្ពែះ	spɛh
ស្ពោត	spoot
ស្ពោរ	spoo
ស្មត់	smɑt
ស្មន់	smɑn
ស្មាញ	smaaɲ
ស្មាន	smaan
ស្មិញ	sməɲ
ស្មិត	smət
ស្មិប	sməp
ស្មឹង	sməŋ
ស្មឹប	sməp
ស្មឹម	sməm
ស្មឺប	sməəp
ស្មុយ	smoj
ស្មុំ	smom
ស្មូញ	smooɲ
ស្មូត	smoot
ស្មូន	smoon
ស្មូម	smoom
ស្មូរ	smoo
ស្មឿក	smɨək
ស្មៀន	smiən
ស្មេញ	smeeɲ
ស្មេរ	smee
ស្មែក	smaek
ស្មែង	smaeŋ
ស្មោក	smaok
ស្មោង	smaoŋ
ស្មោញ	smaoɲ
ស្មោះ	smɑh
ស្យុល	sjol
ស្រករ	srɑ\.kɑɑ
ស្រកា	srɑ\.kaa
ស្រកី	srɑ\.kəj
ស្រក់	srɑk
ស្រគំ	srɑ\.kum
ស្រងក	srɑ\.ŋɑɑk
ស្រងើ	srɑ\.ŋaə
ស្រងែ	srɑ\.ŋae
ស្រងៅ	srɑ\.ŋaw
ស្រង់	srɑŋ
ស្រដី	srɑ\.ɗəj
ស្រទប	srɑ\.tɔɔp
ស្រទំ	srɑ\.tum
ស្រន់	srɑn
ស្រប់	srɑp
ស្រមក	srɑ\.mɑɑk
ស្រមើ	srɑ\.maə
ស្រមៃ	srɑ\.maj
ស្រម៉	srɑɑm
ស្រយម	srɑ\.jɑɑm
ស្រលក	srɑ\.lɑɑk
ស្រលន	srɑ\.lɑɑn
ស្រលើ	srɑ\.laə
ស្រលះ	srɑ\.lah
ស្រល់	srɑl
ស្រវា	srɑ\.waa
ស្រស់	srɑh
ស្រឡក	srɑ\.lɑɑk
ស្រឡន	srɑ\.lɑɑn
ស្រឡើ	srɑ\.laə
ស្រឡៃ	srɑ\.laj
ស្រឡោ	srɑ\.lao
ស្រឡៅ	srɑ\.law
ស្រឡំ	srɑ\.lɑm
ស្រឡះ	srɑ\.lah
ស្រាង	sraaŋ
ស្រាញ	sraaɲ
ស្រាត	sraat
ស្រាយ	sraaj
ស្រាល	sraal
ស្រាវ	sraaw
ស្រាំ	sram
ស្រិច	srəc
ស្រិត	srət
ស្រិប	srəp
ស្រឹង	srəŋ
ស្រឹប	srəp
ស្រឹម	srəm
ស្រុក	srok
ស្រុង	sroŋ
ស្រុញ	sroɲ
ស្រុត	srot
ស្រុស	sroh
ស្រុះ	sroh
ស្រូត	sroot
ស្រូប	sroop
ស្រូល	srool
ស្រូស	srooh
ស្រួច	sruəc
ស្រួត	sruət
ស្រួប	sruəp
ស្រួយ	sruəj
ស្រួល	sruəl
ស្រើប	sraəp
ស្រឿង	srɨəŋ
ស្រៀក	sriək
ស្រៀវ	sriəw
ស្រេក	sreek
ស្រេង	sreeŋ
ស្រេច	sreec
ស្រេះ	sreh
ស្រែក	sraek
ស្រែង	sraeŋ
ស្រែស	sraeh
ស្រែះ	sraeh
ស្រោក	sraok
ស្រោង	sraoŋ
ស្រោច	sraoc
ស្រោប	sraop
ស្រោម	sraom
ស្រោល	sraol
ស្លក់	slɑk
ស្លង់	slɑŋ
ស្លន់	slɑn
ស្លាត	slaat
ស្លាប	slaap
ស្លាយ	slaaj
ស្លឹក	slək
ស្លឹង	sləŋ
ស្លឹប	sləp
ស្លឺត	sləət
ស្លុក	slok
ស្លុង	sloŋ
ស្លុត	slot
ស្លុប	slop
ស្លុយ	sloj
ស្លុះ	sloh
ស្លូញ	slooɲ
ស្លូត	sloot
ស្លើត	slaət
ស្លៀក	sliək
ស្លេក	sleek
ស្លេវ	sleew
ស្លេះ	sleh
ស្លែង	slaeŋ
ស្លែត	slaet
ស្លែវ	slaew
ស្លោក	slaok
ស្លោម	slaom
ស្វាង	swaaŋ
ស្វាត	swaat
ស្វាយ	swaaj
ស្វែង	swaeŋ
ស្វែត	swaet
ស្អប់	sʔɑp
ស្អាង	sʔaaŋ
ស្អាត	sʔaat
ស្អាន	sʔaan
ស្អិត	sʔət
ស្អុង	sʔoŋ
ស្អុយ	sʔoj
ស្អុះ	sʔoh
ស្អូច	sʔooc
ស្អៀច	sʔiəc
ស្អេក	sʔeek
ស្អែក	sʔaek
ស្អែល	sʔael
ហ្នឹង	hnəŋ
ហ្មត់	hmɑt
ហ្មាយ	hmaaj
ហ្មឺន	hməən
ហ្មូត	hmoot
ហ្លាក	hlaak
ហ្លាយ	hlaaj
ហ្លួង	hluəŋ
ហ្វង់	hwɑŋ
ហ្វារ	hwaa
ហ្វឹក	hwək
ហ្វូង	hwooŋ
អក្ខោ	ʔɑ\.kkʰao
អង្ករ	ʔɑŋ\.kɑɑ
អង្កឹ	ʔɑŋ\.kəʔ
អង្កែ	ʔɑŋ\.kae
អង្គទ	ʔɑŋ\.kɔɔt
អង្គរ	ʔɑŋ\.kɔɔ
អង្គា	ʔɑŋ\.kie
អង្គឺ	ʔɑŋ\.kɨɨ
អង្គែ	ʔɑŋ\.kɛɛ
អង្គំ	ʔɑŋ\.kum
អង្រែ	ʔɑŋ\.rae
អង្វរ	ʔɑŋ\.wɑɑ
អញ្ចង	ʔɑɲ\.cɑɑŋ
អញ្ជច	ʔɑɲ\.cɔɔc
អន្ដរ	ʔɑn\.ɗɑɑ
អន្តយ	ʔɑn\.tɑɑj
អន្ថម	ʔɑn\.tʰɑɑm
អន្ទង	ʔɑn\.tɔɔŋ
អន្ធោ	ʔɑn\.tʰoo
អន្លង	ʔɑn\.lɑɑŋ
អន្លើ	ʔɑn\.laə
អន្លៃ	ʔɑn\.laj
អន្សម	ʔɑn\.sɑɑm
អព្ភា	ʔɑ\.ppʰie
អព្យព	ʔɑ\.pjɔɔp
អយ្យា	ʔɑ\.jjie
អល្លោ	ʔɑ\.lloo
អស្មិ	ʔɑ\.smeʔ
អស្រី	ʔɑ\.srəj
អំណត់	ʔɑm\.nɑt
អំណស់	ʔɑm\.nɑh
អំណាច	ʔɑm\.naac
អំណឹះ	ʔɑm\.nəh
អំណោយ	ʔɑm\.naoj
អំនួត	ʔɑm\.nuət
អំបាត	ʔɑm\.ɓaat
អំបាយ	ʔɑm\.ɓaaj
អំបាល	ʔɑm\.ɓaal
អំបិល	ʔɑm\.ɓəl
អំបឹះ	ʔɑm\.ɓəh
អំបុក	ʔɑm\.ɓok
អំបូង	ʔɑm\.ɓooŋ
អំបូរ	ʔɑm\.ɓoo
អំបើះ	ʔɑm\.ɓaəh
អំបែង	ʔɑm\.ɓaeŋ
អំបោស	ʔɑm\.ɓaoh
អំបោះ	ʔɑm\.ɓɑh
អំពល់	ʔɑm\.pul
អំពាច	ʔɑm\.piec
អំពាវ	ʔɑm\.piew
អំពាស	ʔɑm\.pieh
អំពុត	ʔɑm\.put
អំពុះ	ʔɑm\.puh
អំពៀរ	ʔɑm\.piə
អំពេះ	ʔɑm\.peh
អំពែះ	ʔɑm\.pɛh
អំមិញ	ʔɑm\.məɲ
អំលុង	ʔɑm\.loŋ
អំឡុង	ʔɑm\.loŋ
អ្ងែង	ʔŋaeŋ
អ្ហាះ	ʔhaah
អ្ហុះ	ʔhoh
អ្ហូះ	ʔhooh
អ្ហែង	ʔhaeŋ
អ្ហោះ	ʔhɑh
អ្ហ៊ៃ	ʔhej
កក្រិត	kɑ\.krət
កក្រើក	kɑ\.kraək
កក្រោះ	kɑ\.krɑh
កក្អាក	kɑ\.kʔaak
កក្អាយ	kɑ\.kʔaaj
កក្អិច	kɑ\.kʔəc
កក្អិល	kɑ\.kʔəl
កក្អឹក	kɑ\.kʔək
កក្អៀក	kɑ\.kʔiək
កក្អៀច	kɑ\.kʔiəc
កខ្វក់	kɑ\.kwɑk
កខ្វិក	kɑ\.kwək
កង្កុញ	kɑŋ\.koɲ
កង្កួច	kɑŋ\.kuəc
កង្កួញ	kɑŋ\.kuəɲ
កង្កែប	kɑŋ\.kaep
កង្ខើញ	kɑŋ\.kʰaəɲ
កង្វល់	kɑŋ\.wɑl
កង្វារ	kɑŋ\.waa
កង្វិន	kɑŋ\.wən
កង្វេរ	kɑŋ\.wee
កង្ហារ	kɑŋ\.haa
កង្ហិច	kɑŋ\.həc
កង្ហែន	kɑŋ\.haen
កញ្ចក់	kɑɲ\.cɑk
កញ្ចប់	kɑɲ\.cɑp
កញ្ចាម	kɑɲ\.caam
កញ្ចុំ	kɑɲ\.com
កញ្ចុះ	kɑɲ\.coh
កញ្ចូញ	kɑɲ\.cooɲ
កញ្ចោង	kɑɲ\.caoŋ
កញ្ចោត	kɑɲ\.caot
កញ្ចោប	kɑɲ\.caop
កញ្ឆក់	kɑɲ\.cʰɑk
កញ្ឆាញ	kɑɲ\.cʰaaɲ
កញ្ឆិត	kɑɲ\.cʰət
កញ្ឆិល	kɑɲ\.cʰəl
កញ្ឆឹម	kɑɲ\.cʰəm
កញ្ឆួង	kɑɲ\.cʰuəŋ
កញ្ឆើញ	kɑɲ\.cʰaəɲ
កញ្ឆៀវ	kɑɲ\.cʰiəw
កញ្ឆេង	kɑɲ\.cʰeeŋ
កញ្ឆែត	kɑɲ\.cʰaet
កញ្ឆែវ	kɑɲ\.cʰaew
កញ្ឆោត	kɑɲ\.cʰaot
កញ្ជង់	kɑɲ\.cuŋ
កញ្ជប់	kɑɲ\.cup
កញ្ជាត	kɑɲ\.ciet
កញ្ជែះ	kɑɲ\.cɛh
កញ្ឈូស	kɑɲ\.cʰuuh
កណ្ដក់	kɑn\.ɗɑk
កណ្ដាច	kɑn\.ɗaac
កណ្ដារ	kɑn\.ɗaa
កណ្ដាល	kɑn\.ɗaal
កណ្ដឹង	kɑn\.ɗəŋ
កណ្ដុក	kɑn\.ɗok
កណ្ដុរ	kɑn\.ɗo
កណ្ដូង	kɑn\.ɗooŋ
កណ្ដូប	kɑn\.ɗoop
កណ្ដួយ	kɑn\.ɗuəj
កណ្ដៀង	kɑn\.ɗiəŋ
កណ្ដៀត	kɑn\.ɗiət
កណ្ដៀន	kɑn\.ɗiən
កណ្ដៀរ	kɑn\.ɗiə
កណ្ដៀវ	kɑn\.ɗiəw
កណ្ដេង	kɑn\.ɗeeŋ
កណ្ដោច	kɑn\.ɗaoc
កណ្ដោល	kɑn\.ɗaol
កន្ដាញ	kɑn\.ɗaaɲ
កន្តិល	kɑn\.təl
កន្តឹប	kɑn\.təp
កន្តឹម	kɑn\.təm
កន្តុញ	kɑn\.toɲ
កន្តុប	kɑn\.top
កន្តុល	kɑn\.tol
កន្តើយ	kɑn\.taəj
កន្ត្រ	kɑn\.trɑɑ
កន្ថឹក	kɑn\.tʰək
កន្ថោរ	kɑn\.tʰao
កន្ទឹស	kɑn\.tɨh
កន្ទុយ	kɑn\.tuj
កន្ទុល	kɑn\.tul
កន្ទួត	kɑn\.tuət
កន្ទួល	kɑn\.tuəl
កន្ទើញ	kɑn\.təəɲ
កន្ទេល	kɑn\.teel
កន្ទែក	kɑn\.tɛɛk
កន្ទោក	kɑn\.took
កន្ទោង	kɑn\.tooŋ
កន្ធាញ	kɑn\.tʰieɲ
កន្ធាយ	kɑn\.tʰiej
កន្ធីង	kɑn\.tʰiiŋ
កន្ធឹប	kɑn\.tʰɨp
កន្ធុក	kɑn\.tʰuk
កន្ធុច	kɑn\.tʰuc
កន្ធុល	kɑn\.tʰul
កន្ធួក	kɑn\.tʰuək
កន្ធែក	kɑn\.tʰɛɛk
កន្លង់	kɑn\.lɑŋ
កន្លាត	kɑn\.laat
កន្លុក	kɑn\.lok
កន្លុះ	kɑn\.loh
កន្លើត	kɑn\.laət
កន្លៀត	kɑn\.liət
កន្លេង	kɑn\.leeŋ
កន្លែង	kɑn\.laeŋ
កន្លោង	kɑn\.laoŋ
កន្សុំ	kɑn\.som
កន្សែង	kɑn\.saeŋ
កន្សោម	kɑn\.saom
កប៉ាល់	kɑ\.pal
កម្ចាយ	kɑm\.caaj
កម្ជិល	kɑm\.cɨl
កម្ជេញ	kɑm\.ceeɲ
កម្ទារ	kɑm\.tie
កម្ទេច	kɑm\.teec
កម្បង់	kɑm\.ɓɑŋ
កម្ពស់	kɑm\.puəh
កម្រាញ	kɑm\.raaɲ
កម្រាប	kɑm\.raap
កម្រាល	kɑm\.raal
កម្រិត	kɑm\.rət
កម្រិន	kɑm\.rən
កម្រើក	kɑm\.raək
កម្រៀម	kɑm\.riəm
កម្រៀវ	kɑm\.riəw
កម្លាច	kɑm\.laac
កម្លោច	kɑm\.laoc
កម្សត់	kɑm\.sɑt
កម្សួល	kɑm\.suəl
កម្សោយ	kɑm\.saoj
កម្អួត	kɑm\.ʔuət
កម្អែល	kɑm\.ʔael
កំណាច់	kɑm\.nac
កំណាញ់	kɑm\.naɲ
កំណាត់	kɑm\.nat
កំណាន់	kɑm\.nan
កំបាក់	kɑm\.ɓak
កំបាំង	kɑm\.ɓaŋ
កំប៉ាង	kɑm\.paaŋ
កំប៉ាត	kɑm\.paat
កំប៉ឺត	kɑm\.pəət
កំប៉ុក	kɑm\.pok
កំប៉ុង	kɑm\.poŋ
កំប៉ុល	kɑm\.pol
កំប៉ូត	kɑm\.poot
កំប៉ើញ	kɑm\.paəɲ
កំប៉េង	kɑm\.peeŋ
កំប៉េះ	kɑm\.peh
កំប៉ែត	kɑm\.paet
កំប៉ោង	kɑm\.paoŋ
កំប៉ោយ	kɑm\.paoj
កំព្រយ	kɑm\.prɔɔj
កំព្រា	kɑm\.prie
កំហាត់	kɑm\.hat
ក្ដាត់	kɗat
ក្ដាន់	kɗan
ក្ដាប់	kɗap
ក្ដាំង	kɗaŋ
ក្ឌាំង	kɗeaŋ
ក្នាញ់	knaɲ
ក្បាក់	kɓak
ក្បាច់	kɓac
ក្បាំង	kɓaŋ
ក្រខុប	krɑ\.kʰop
ក្រចាស	krɑ\.caah
ក្រចេះ	krɑ\.ceh
ក្រជាំ	krɑ\.coam
ក្រជីង	krɑ\.ciiŋ
ក្រញង់	krɑ\.ɲɑŋ
ក្រញាង	krɑ\.ɲaaŋ
ក្រញាស	krɑ\.ɲaah
ក្រញាំ	krɑ\.ɲam
ក្រញឹង	krɑ\.ɲəŋ
ក្រញឹប	krɑ\.ɲəp
ក្រញឹម	krɑ\.ɲəm
ក្រញុច	krɑ\.ɲoc
ក្រញុញ	krɑ\.ɲoɲ
ក្រញុល	krɑ\.ɲol
ក្រញុះ	krɑ\.ɲoh
ក្រញូវ	krɑ\.ɲoow
ក្រញូស	krɑ\.ɲooh
ក្រញើត	krɑ\.ɲaət
ក្រញេង	krɑ\.ɲeeŋ
ក្រញេញ	krɑ\.ɲeeɲ
ក្រញេស	krɑ\.ɲeeh
ក្រញោន	krɑ\.ɲaon
ក្រដាស	krɑ\.ɗaah
ក្រតើន	krɑ\.taən
ក្រទឺត	krɑ\.tɨɨt
ក្រនៀវ	krɑ\.niəw
ក្របួច	krɑ\.ɓuəc
ក្របែល	krɑ\.ɓael
ក្រពឹត	krɑ\.pɨt
ក្រពុល	krɑ\.pul
ក្រពុំ	krɑ\.pum
ក្រពេញ	krɑ\.peeɲ
ក្រពេន	krɑ\.peen
ក្រមប់	krɑ\.mɑp
ក្រមាច	krɑ\.maac
ក្រមាំ	krɑ\.mam
ក្រមឹម	krɑ\.məm
ក្រមឺម	krɑ\.məəm
ក្រមុប	krɑ\.mop
ក្រមុំ	krɑ\.mom
ក្រមួន	krɑ\.muən
ក្រលៀន	krɑ\.liən
ក្រវង់	krɑ\.wɑŋ
ក្រវាញ	krɑ\.waaɲ
ក្រវាម	krɑ\.waam
ក្រវិន	krɑ\.wən
ក្រវិល	krɑ\.wəl
ក្រវឹម	krɑ\.wəm
ក្រវើន	krɑ\.waən
ក្រវៀច	krɑ\.wiəc
ក្រវៀន	krɑ\.wiən
ក្រវេច	krɑ\.weec
ក្រវែល	krɑ\.wael
ក្រសារ	krɑ\.saa
ក្រសាល	krɑ\.saal
ក្រសាវ	krɑ\.saaw
ក្រសួង	krɑ\.suəŋ
ក្រសៀន	krɑ\.siən
ក្រសោប	krɑ\.saop
ក្រហល់	krɑ\.hɑl
ក្រហាយ	krɑ\.haaj
ក្រហូង	krɑ\.hooŋ
ក្រហួង	krɑ\.huəŋ
ក្រហួច	krɑ\.huəc
ក្រហេង	krɑ\.heeŋ
ក្រហេត	krɑ\.heet
ក្រហែង	krɑ\.haeŋ
ក្រហែត	krɑ\.haet
ក្រឡង់	krɑ\.lɑŋ
ក្រឡាញ	krɑ\.laaɲ
ក្រឡាន	krɑ\.laan
ក្រឡិច	krɑ\.ləc
ក្រឡិត	krɑ\.lət
ក្រឡឹង	krɑ\.ləŋ
ក្រឡឹប	krɑ\.ləp
ក្រឡឹម	krɑ\.ləm
ក្រឡឺម	krɑ\.ləəm
ក្រឡុញ	krɑ\.loɲ
ក្រឡុប	krɑ\.lop
ក្រឡូម	krɑ\.loom
ក្រឡេក	krɑ\.leek
ក្រឡេច	krɑ\.leec
ក្រឡែត	krɑ\.laet
ក្រឡោត	krɑ\.laot
ក្រអាញ	krɑ\.ʔaaɲ
ក្រអឺត	krɑ\.ʔəət
ក្រអុច	krɑ\.ʔoc
ក្រអុល	krɑ\.ʔol
ក្រអូប	krɑ\.ʔoop
ក្រអូម	krɑ\.ʔoom
ក្រអួន	krɑ\.ʔuən
ក្រអេក	krɑ\.ʔeek
ក្រអែប	krɑ\.ʔaep
ក្រអែស	krɑ\.ʔaeh
ក្រាក់	krak
ក្រាញ់	kraɲ
ក្រាប់	krap
ក្រាល់	kral
ក្រាស់	krah
ក្រាំង	kraŋ
ក្លាក់	klak
ក្លាត់	klat
ក្លាស់	klah
ក្អាត់	kʔat
ខ្ចាត់	kcat
ខ្ចាស់	kcah
ខ្ជាក់	kceak
ខ្ជាន់	kcoan
ខ្ជាប់	kcoap
ខ្ជាំង	kceaŋ
ខ្ញាល់	kɲal
ខ្ទាស់	ktoah
ខ្នាច់	knac
ខ្នាន់	knan
ខ្ពាក់	kpeak
ខ្ពាប់	kpoap
ខ្មាញ់	kmaɲ
ខ្មាន់	kman
ខ្មាំង	kmaŋ
ខ្លាញ់	klaɲ
ខ្លាំង	klaŋ
ខ្វាក់	kwak
ខ្វាច់	kwac
ខ្វាត់	kwat
ខ្វាន់	kwan
ខ្វាប់	kwap
ខ្សាច់	ksac
គគ្រក់	kɔ\.kruək
គគ្រន់	kɔ\.krun
គគ្រាត	kɔ\.kriet
គគ្រាំ	kɔ\.kroam
គគ្រិច	kɔ\.krɨc
គគ្រិះ	kɔ\.krih
គគ្រីវ	kɔ\.kriiw
គគ្រឹក	kɔ\.krɨk
គគ្រឹម	kɔ\.krɨm
គគ្រឺត	kɔ\.krɨɨt
គគ្រុក	kɔ\.kruk
គគ្រុម	kɔ\.krum
គគ្រុយ	kɔ\.kruj
គគ្រូក	kɔ\.kruuk
គគ្រួប	kɔ\.kruəp
គគ្រើម	kɔ\.krəəm
គគ្រេង	kɔ\.kreeŋ
គគ្រោក	kɔ\.krook
គឃ្លើន	kɔ\.kləən
គង្គាន	kuŋ\.kien
គង្គួន	kuŋ\.kuən
គង្វាល	kuŋ\.wiel
គន្លឹះ	kun\.lɨh
គន្លោង	kun\.looŋ
គម្រក់	kum\.ruək
គម្រប់	kum\.rup
គម្រិះ	kum\.rih
គម្រៀវ	kum\.riəw
គម្រេច	kum\.reec
គម្រោង	kum\.rooŋ
គម្លង់	kum\.luŋ
គម្លាន	kum\.lien
គំនាក់	kum\.neak
គំនាប់	kum\.noap
គំនាល់	kum\.noal
គំនាស់	kum\.noah
គំហាត់	kum\.hat
គ្នាន់	knoan
គ្រជាំ	krɔ\.coam
គ្រជីវ	krɔ\.ciiw
គ្រជឹប	krɔ\.cɨp
គ្រជូរ	krɔ\.cuu
គ្រញិច	krɔ\.ɲɨc
គ្រញឹក	krɔ\.ɲɨk
គ្រញូង	krɔ\.ɲuuŋ
គ្រញែង	krɔ\.ɲɛɛŋ
គ្រមល់	krɔ\.mul
គ្រមាក	krɔ\.miek
គ្រមាញ	krɔ\.mieɲ
គ្រមាម	krɔ\.miem
គ្រមើម	krɔ\.məəm
គ្រលង់	krɔ\.luŋ
គ្រលីត	krɔ\.liit
គ្រលុក	krɔ\.luk
គ្រលួង	krɔ\.luəŋ
គ្រលួច	krɔ\.luəc
គ្រលៀវ	krɔ\.liəw
គ្រលៀស	krɔ\.liəh
គ្រលេវ	krɔ\.leew
គ្រលែង	krɔ\.lɛɛŋ
គ្រវាស	krɔ\.wieh
គ្រវីស	krɔ\.wiih
គ្រវៀច	krɔ\.wiəc
គ្រវៀន	krɔ\.wiən
គ្រវែង	krɔ\.wɛɛŋ
គ្រហាញ	krɔ\.haaɲ
គ្រហីត	krɔ\.həjt
គ្រហឹម	krɔ\.həm
គ្រហុច	krɔ\.hoc
គ្រហុប	krɔ\.hop
គ្រហួង	krɔ\.huəŋ
គ្រហួច	krɔ\.huəc
គ្រហួប	krɔ\.huəp
គ្រហែត	krɔ\.haet
គ្រហែម	krɔ\.haem
គ្រាក់	kreak
គ្រាន់	kroan
គ្រាប់	kroap
គ្រាំង	kreaŋ
ឃ្លាំង	kleaŋ
ចង្កឹះ	cɑŋ\.kəh
ចង្កូត	cɑŋ\.koot
ចង្កូម	cɑŋ\.koom
ចង្កួយ	cɑŋ\.kuəj
ចង្កៀង	cɑŋ\.kiəŋ
ចង្កៀល	cɑŋ\.kiəl
ចង្កៀស	cɑŋ\.kiəh
ចង្កេះ	cɑŋ\.keh
ចង្កោម	cɑŋ\.kaom
ចង្រប់	cɑŋ\.rɑp
ចង្រិត	cɑŋ\.rət
ចង្រុះ	cɑŋ\.roh
ចង្វាយ	cɑŋ\.waaj
ចង្វែក	cɑŋ\.waek
ចង្ហាយ	cɑŋ\.haaj
ចង្ហូរ	cɑŋ\.hoo
ចង្អល់	cɑŋ\.ʔɑl
ចង្អុល	cɑŋ\.ʔol
ចង្អូរ	cɑŋ\.ʔoo
ចង្អួរ	cɑŋ\.ʔuə
ចង្អើរ	cɑŋ\.ʔaə
ចង្អៀត	cɑŋ\.ʔiət
ចង្អេរ	cɑŋ\.ʔee
ចង្អោរ	cɑŋ\.ʔao
ចន្ទល់	cɑn\.tul
ចន្ទាស	cɑn\.tieh
ចន្ទោល	cɑn\.tool
ចន្លន់	cɑn\.lɑn
ចន្លុះ	cɑn\.loh
ចន្លោង	cɑn\.laoŋ
ចន្លោះ	cɑn\.lɑh
ចម្ការ	cɑm\.kaa
ចម្កួត	cɑm\.kuət
ចម្ងាយ	cɑm\.ŋaaj
ចម្ពាម	cɑm\.piem
ចម្រត់	cɑm\.rɑt
ចម្រាញ	cɑm\.raaɲ
ចម្រាន	cɑm\.raan
ចម្រាស	cɑm\.raah
ចម្រឹង	cɑm\.rəŋ
ចម្រុង	cɑm\.roŋ
ចម្រុះ	cɑm\.roh
ចម្រូង	cɑm\.rooŋ
ចម្រូត	cɑm\.root
ចម្រើន	cɑm\.raən
ចម្រៀក	cɑm\.riək
ចម្រៀង	cɑm\.riəŋ
ចម្រេះ	cɑm\.reh
ចម្រោក	cɑm\.raok
ចម្រោះ	cɑm\.rɑh
ចម្លើយ	cɑm\.laəj
ចម្លែក	cɑm\.laek
ចម្អាប	cɑm\.ʔaap
ចម្អិន	cɑm\.ʔən
ចម្អឹង	cɑm\.ʔəŋ
ចម្អេះ	cɑm\.ʔeh
ចម្អែត	cɑm\.ʔaet
ចំណាក់	cɑm\.nak
ចំណាញ់	cɑm\.naɲ
ចំណាប់	cɑm\.nap
ចំណាល់	cɑm\.nal
ចំណាស់	cɑm\.nah
ចំណាំង	cɑm\.naŋ
ចំទាស់	cɑm\.toah
ចំទាំង	cɑm\.teaŋ
ចំបាប់	cɑm\.ɓap
ចំពាក់	cɑm\.peak
ចំពាស់	cɑm\.poah
ចំហាំង	cɑm\.haŋ
ច្បាក់	cɓak
ច្បាប់	cɓap
ច្បាំង	cɓaŋ
ច្រកែង	crɑ\.kaeŋ
ច្រគាង	crɑ\.kieŋ
ច្រងក់	crɑ\.ŋɑk
ច្រងាង	crɑ\.ŋaaŋ
ច្រងាម	crɑ\.ŋaam
ច្រងូវ	crɑ\.ŋoow
ច្រណែន	crɑ\.naen
ច្រនួច	crɑ\.nuəc
ច្រនៀង	crɑ\.niəŋ
ច្របល់	crɑ\.ɓɑl
ច្របុច	crɑ\.ɓoc
ច្របូក	crɑ\.ɓook
ច្របូញ	crɑ\.ɓooɲ
ច្រពើង	crɑ\.pəəŋ
ច្រពើស	crɑ\.pəəh
ច្រមក់	crɑ\.mɑk
ច្រមិច	crɑ\.məc
ច្រមុះ	crɑ\.moh
ច្រមូញ	crɑ\.mooɲ
ច្រមូល	crɑ\.mool
ច្រមួន	crɑ\.muən
ច្រវាប	crɑ\.waap
ច្រវេះ	crɑ\.weh
ច្រវែប	crɑ\.waep
ច្រវោះ	crɑ\.wɑh
ច្រហាប	crɑ\.haap
ច្រហេញ	crɑ\.heeɲ
ច្រហោង	crɑ\.haoŋ
ច្រហោះ	crɑ\.hɑh
ច្រឡាម	crɑ\.laam
ច្រឡាស	crɑ\.laah
ច្រឡឹង	crɑ\.ləŋ
ច្រឡឺម	crɑ\.ləəm
ច្រឡុង	crɑ\.loŋ
ច្រឡូក	crɑ\.look
ច្រឡើយ	crɑ\.laəj
ច្រឡើស	crɑ\.laəh
ច្រឡេះ	crɑ\.leh
ច្រឡោត	crɑ\.laot
ច្រអាង	crɑ\.ʔaaŋ
ច្រអឹង	crɑ\.ʔəŋ
ច្រអូស	crɑ\.ʔooh
ច្រាច់	crac
ច្រាល់	cral
ច្រាំង	craŋ
ឆ្ងាញ់	cŋaɲ
ឆ្នាក់	cnak
ឆ្នាល់	cnal
ឆ្នាំង	cnaŋ
ឆ្មាត់	cmat
ឆ្លាក់	clak
ឆ្លាស់	clah
ឆ្លាំង	claŋ
ឆ្វាក់	cwak
ជង្គង់	cuŋ\.kuŋ
ជង្ហុក	cuŋ\.hok
ជញ្ជក់	cuɲ\.cuək
ជញ្ជាប	cuɲ\.ciep
ជញ្ជីង	cuɲ\.ciiŋ
ជញ្ជឹង	cuɲ\.cɨŋ
ជញ្ជូន	cuɲ\.cuun
ជញ្ជួច	cuɲ\.cuəc
ជញ្ជួយ	cuɲ\.cuəj
ជញ្ជែង	cuɲ\.cɛɛŋ
ជណ្ដើរ	cun\.ɗaə
ជន្លង់	cun\.luŋ
ជន្លាស	cun\.lieh
ជន្លូស	cun\.luuh
ជន្លួញ	cun\.luəɲ
ជន្លេញ	cun\.leeɲ
ជន្លេន	cun\.leen
ជម្រាប	cum\.riep
ជម្រាល	cum\.riel
ជម្រុល	cum\.rul
ជម្រុះ	cum\.ruh
ជម្រួញ	cum\.ruəɲ
ជម្រើស	cum\.rəəh
ជម្រេញ	cum\.reeɲ
ជម្រែក	cum\.rɛɛk
ជម្រោង	cum\.rooŋ
ជម្លើយ	cum\.ləəj
ជម្លៀស	cum\.liəh
ជម្លោះ	cum\.luəh
ជំទាស់	cum\.toah
ជំទាំង	cum\.teaŋ
ជំនាត់	cum\.noat
ជំនាន់	cum\.noan
ជំនាប់	cum\.noap
ជំពាក់	cum\.peak
ជ្រងក់	crɔ\.ŋuək
ជ្រនង់	crɔ\.nuŋ
ជ្រនីក	crɔ\.niik
ជ្រនួច	crɔ\.nuəc
ជ្រនៀង	crɔ\.niəŋ
ជ្រមីស	crɔ\.miih
ជ្រមុជ	crɔ\.muc
ជ្រមូស	crɔ\.muuh
ជ្រលក់	crɔ\.luək
ជ្រលិះ	crɔ\.lih
ជ្រលួស	crɔ\.luəh
ជ្រលៀក	crɔ\.liək
ជ្រលែង	crɔ\.lɛɛŋ
ជ្រាំង	creaŋ
ឈ្នាន់	cnoan
ឈ្វាំង	cweaŋ
ដង្កាវ	ɗɑŋ\.kaaw
ដង្កូវ	ɗɑŋ\.koow
ដង្គត់	ɗɑŋ\.kut
ដង្គន់	ɗɑŋ\.kun
ដង្គុំ	ɗɑŋ\.kum
ដង្គោល	ɗɑŋ\.kool
ដង្វិន	ɗɑŋ\.wən
ដង្ហក់	ɗɑŋ\.hɑk
ដង្ហិត	ɗɑŋ\.hət
ដង្ហើម	ɗɑŋ\.haəm
ដង្ហោយ	ɗɑŋ\.haoj
ដណ្ដប់	ɗɑn\.ɗɑp
ដណ្ដាំ	ɗɑn\.ɗam
ដណ្ដឹង	ɗɑn\.ɗəŋ
ដណ្ដើម	ɗɑn\.ɗaəm
ដំណាក់	ɗɑm\.nak
ដំណាច់	ɗɑm\.nac
ដំណាប់	ɗɑm\.nap
ដំណាល់	ɗɑm\.nal
ដំណាស់	ɗɑm\.nah
ដំឡាន់	ɗɑm\.lan
តង្កៀប	tɑŋ\.kiəp
តង្វាយ	tɑŋ\.waaj
តន្ថើន	tɑn\.tʰaən
តម្កល់	tɑm\.kɑl
តម្កើង	tɑm\.kaəŋ
តម្បាញ	tɑm\.ɓaaɲ
តម្បារ	tɑm\.ɓaa
តម្បុត	tɑm\.ɓot
តម្បៀត	tɑm\.ɓiət
តម្ពក់	tɑm\.puək
តម្ពេច	tɑm\.peec
តម្ពែក	tɑm\.pɛɛk
តម្រង់	tɑm\.rɑŋ
តម្រាយ	tɑm\.raaj
តម្រាំ	tɑm\.ram
តម្រិះ	tɑm\.reh
តម្រឹម	tɑm\.rəm
តម្រុយ	tɑm\.roj
តម្រូវ	tɑm\.roow
តម្រួត	tɑm\.ruət
តម្រៀប	tɑm\.riəp
តម្រេក	tɑm\.reek
តម្លង់	tɑm\.lɑŋ
តម្លឹង	tɑm\.ləŋ
តម្លុញ	tɑm\.loɲ
តម្លោះ	tɑm\.lɑh
តម្អឹង	tɑm\.ʔəŋ
តម្អូញ	tɑm\.ʔooɲ
តំណាប់	tɑm\.nap
តំណាំង	tɑm\.naŋ
ត្បាល់	tɓal
ត្រកាល	trɑ\.kaal
ត្រកូល	trɑ\.kool
ត្រកួញ	trɑ\.kuəɲ
ត្រកួត	trɑ\.kuət
ត្រកួន	trɑ\.kuən
ត្រកៀត	trɑ\.kiət
ត្រគាក	trɑ\.kiek
ត្រងាល	trɑ\.ŋaal
ត្រងិល	trɑ\.ŋəl
ត្រងើល	trɑ\.ŋaəl
ត្រងោល	trɑ\.ŋaol
ត្រចង់	trɑ\.cɑŋ
ត្រចើល	trɑ\.caəl
ត្រចៀក	trɑ\.ciək
ត្រឈឹង	trɑ\.cʰɨŋ
ត្រដក់	trɑ\.ɗɑk
ត្រដាង	trɑ\.ɗaaŋ
ត្រដាច	trɑ\.ɗaac
ត្រដិត	trɑ\.ɗət
ត្រដឹង	trɑ\.ɗəŋ
ត្រដឹម	trɑ\.ɗəm
ត្រដុស	trɑ\.ɗoh
ត្រដួច	trɑ\.ɗuəc
ត្រដេប	trɑ\.ɗeep
ត្រដេវ	trɑ\.ɗeew
ត្រដែត	trɑ\.ɗaet
ត្រដោក	trɑ\.ɗaok
ត្រដោម	trɑ\.ɗaom
ត្រដោះ	trɑ\.ɗɑh
ត្រណោត	trɑ\.naot
ត្រថុក	trɑ\.tʰok
ត្រថឿង	trɑ\.tʰɨəŋ
ត្របែក	trɑ\.ɓaek
ត្របែង	trɑ\.ɓaeŋ
ត្របោម	trɑ\.ɓaom
ត្រប៉ែ	trɑ\.pae
ត្រពីង	trɑ\.piiŋ
ត្រពឹន	trɑ\.pɨn
ត្រពោក	trɑ\.pook
ត្រមក់	trɑ\.mɑk
ត្រមង់	trɑ\.mɑŋ
ត្រមុល	trɑ\.mol
ត្រមៀច	trɑ\.miəc
ត្រមែង	trɑ\.maeŋ
ត្រមោង	trɑ\.maoŋ
ត្រមោច	trɑ\.maoc
ត្រមោល	trɑ\.maol
ត្រយង់	trɑ\.jɑŋ
ត្រយូង	trɑ\.jooŋ
ត្រលប់	trɑ\.lɑp
ត្រលិន	trɑ\.lən
ត្រលុច	trɑ\.loc
ត្រសក់	trɑ\.sɑk
ត្រសាយ	trɑ\.saaj
ត្រសុក	trɑ\.sok
ត្រសុល	trɑ\.sol
ត្រសុស	trɑ\.soh
ត្រសុំ	trɑ\.som
ត្រសូល	trɑ\.sool
ត្រសៀក	trɑ\.siək
ត្រសេះ	trɑ\.seh
ត្រសែត	trɑ\.saet
ត្រសោម	trɑ\.saom
ត្រសោល	trɑ\.saol
ត្រឡាច	trɑ\.laac
ត្រឡាយ	trɑ\.laaj
ត្រឡុង	trɑ\.loŋ
ត្រឡុំ	trɑ\.lom
ត្រឡោក	trɑ\.laok
ត្រអាល	trɑ\.ʔaal
ត្រអៀន	trɑ\.ʔiən
ត្រអេក	trɑ\.ʔeek
ត្រាក់	trak
ត្រាច់	trac
ត្រាញ់	traɲ
ត្រាប់	trap
ត្រាស់	trah
ថ្កាត់	tkat
ថ្កាប់	tkap
ថ្ងាន់	tŋan
ថ្នាក់	tnak
ថ្នាំង	tnaŋ
ថ្ពាល់	tpoal
ថ្មាត់	tmat
ថ្លាញ់	tlaɲ
ថ្លាន់	tlan
ថ្វាត់	twat
ទង្គត់	tuŋ\.kut
ទង្គិច	tuŋ\.kɨc
ទង្គឹះ	tuŋ\.kɨh
ទង្គុក	tuŋ\.kuk
ទង្គុំ	tuŋ\.kum
ទង្គោល	tuŋ\.kool
ទទ្រឹប	tɔ\.trɨp
ទទ្រើក	tɔ\.trəək
ទទ្រើត	tɔ\.trəət
ទន្ថើន	tun\.tʰaən
ទន្ទាំ	tun\.toam
ទន្ទិញ	tun\.tɨɲ
ទន្ទឹង	tun\.tɨŋ
ទន្ទឹម	tun\.tɨm
ទន្ទូរ	tun\.tuu
ទន្ទេង	tun\.teeŋ
ទន្ទេញ	tun\.teeɲ
ទន្លីង	tun\.liiŋ
ទន្សាយ	tun\.saaj
ទន្សោង	tun\.saoŋ
ទម្ងន់	tum\.ŋun
ទម្រង់	tum\.ruŋ
ទម្រន់	tum\.run
ទម្រាំ	tum\.roam
ទម្រឹង	tum\.rɨŋ
ទម្រុឌ	tum\.rut
ទម្រើស	tum\.rəəh
ទម្រេត	tum\.reet
ទម្រេល	tum\.reel
ទម្រោប	tum\.roop
ទម្រោម	tum\.room
ទម្លាយ	tum\.liej
ទម្លុះ	tum\.luh
ទំនាក់	tum\.neak
ទំនាន់	tum\.noan
ទំនាល់	tum\.noal
ទំនាស់	tum\.noah
ទំពាំង	tum\.peaŋ
ទំហាត់	tum\.hat
ទ្រគោះ	trɔ\.kuəh
ទ្រងាង	trɔ\.ŋieŋ
ទ្រងើង	trɔ\.ŋəəŋ
ទ្រងើល	trɔ\.ŋəəl
ទ្រទូង	trɔ\.tuuŋ
ទ្រទួយ	trɔ\.tuəj
ទ្រទេស	trɔ\.teeh
ទ្រនង់	trɔ\.nuŋ
ទ្រនល់	trɔ\.nul
ទ្រនិច	trɔ\.nɨc
ទ្រនឹប	trɔ\.nɨp
ទ្រនុង	trɔ\.nuŋ
ទ្រនុល	trɔ\.nul
ទ្រនូល	trɔ\.nuul
ទ្រនើរ	trɔ\.nəə
ទ្រនេល	trɔ\.neel
ទ្រនេស	trɔ\.neeh
ទ្រមក់	trɔ\.muək
ទ្រមល់	trɔ\.mul
ទ្រមាក	trɔ\.miek
ទ្រមីង	trɔ\.miiŋ
ទ្រមឹង	trɔ\.mɨŋ
ទ្រមូង	trɔ\.muuŋ
ទ្រមួច	trɔ\.muəc
ទ្រមើង	trɔ\.məəŋ
ទ្រមើម	trɔ\.məəm
ទ្រមើយ	trɔ\.məəj
ទ្រមេញ	trɔ\.meeɲ
ទ្រមេម	trɔ\.meem
ទ្រមែង	trɔ\.mɛɛŋ
ទ្រយាន	trɔ\.jien
ទ្រយឹង	trɔ\.jɨŋ
ទ្រយុក	trɔ\.juk
ទ្រលន់	trɔ\.lun
ទ្រលុក	trɔ\.luk
ទ្រលោម	trɔ\.loom
ទ្រវៀច	trɔ\.wiəc
ទ្រវែង	trɔ\.wɛɛŋ
ទ្រហឹង	trɔ\.həŋ
ទ្រាន់	troan
ទ្រាប់	troap
ទ្រាំង	treaŋ
ធ្ងាំង	tŋeaŋ
ធ្នាក់	tneak
ធ្នាប់	tnoap
ធ្មាំង	tmeaŋ
ធ្លាក់	tleak
ធ្លាប់	tloap
ធ្លាំង	tleaŋ
បង្កក់	ɓɑŋ\.kɑk
បង្កង់	ɓɑŋ\.kɑŋ
បង្កប់	ɓɑŋ\.kɑp
បង្ការ	ɓɑŋ\.kaa
បង្កិន	ɓɑŋ\.kən
បង្កិល	ɓɑŋ\.kəl
បង្កុង	ɓɑŋ\.koŋ
បង្កូក	ɓɑŋ\.kook
បង្កួយ	ɓɑŋ\.kuəj
បង្កើច	ɓɑŋ\.kaəc
បង្កើត	ɓɑŋ\.kaət
បង្កើន	ɓɑŋ\.kaən
បង្កើយ	ɓɑŋ\.kaəj
បង្កើល	ɓɑŋ\.kaəl
បង្កឿង	ɓɑŋ\.kɨəŋ
បង្កៀរ	ɓɑŋ\.kiə
បង្កេល	ɓɑŋ\.keel
បង្កែក	ɓɑŋ\.kaek
បង្កោង	ɓɑŋ\.kaoŋ
បង្ខាក	ɓɑŋ\.kʰaak
បង្ខាត	ɓɑŋ\.kʰaat
បង្ខាន	ɓɑŋ\.kʰaan
បង្ខាំ	ɓɑŋ\.kʰam
បង្ខិត	ɓɑŋ\.kʰət
បង្ខុស	ɓɑŋ\.kʰoh
បង្ខូង	ɓɑŋ\.kʰooŋ
បង្ខូច	ɓɑŋ\.kʰooc
បង្ខើច	ɓɑŋ\.kʰaəc
បង្គន់	ɓɑŋ\.kun
បង្គាន	ɓɑŋ\.kien
បង្គាវ	ɓɑŋ\.kiew
បង្គុយ	ɓɑŋ\.kuj
បង្គួរ	ɓɑŋ\.kuə
បង្គេច	ɓɑŋ\.keec
បង្គោល	ɓɑŋ\.kool
បង្គោះ	ɓɑŋ\.kuəh
បង្បោយ	ɓɑŋ\.ɓaoj
បង្រាស	ɓɑŋ\.raah
បង្រុះ	ɓɑŋ\.roh
បង្រួញ	ɓɑŋ\.ruəɲ
បង្រួប	ɓɑŋ\.ruəp
បង្រួម	ɓɑŋ\.ruəm
បង្រៀន	ɓɑŋ\.riən
បង្រោស	ɓɑŋ\.raoh
បង្វិល	ɓɑŋ\.wəl
បង្វឹក	ɓɑŋ\.wək
បង្វៀន	ɓɑŋ\.wiən
បង្វៀះ	ɓɑŋ\.wiəh
បង្វេច	ɓɑŋ\.weec
បង្វេះ	ɓɑŋ\.weh
បង្វែង	ɓɑŋ\.waeŋ
បង្វែរ	ɓɑŋ\.wae
បង្ហក់	ɓɑŋ\.hɑk
បង្ហត់	ɓɑŋ\.hɑt
បង្ហប់	ɓɑŋ\.hɑp
បង្ហល់	ɓɑŋ\.hɑl
បង្ហាញ	ɓɑŋ\.haaɲ
បង្ហិន	ɓɑŋ\.hən
បង្ហិល	ɓɑŋ\.həl
បង្ហុយ	ɓɑŋ\.hoj
បង្ហូត	ɓɑŋ\.hoot
បង្ហូរ	ɓɑŋ\.hoo
បង្ហួត	ɓɑŋ\.huət
បង្ហួរ	ɓɑŋ\.huə
បង្ហួល	ɓɑŋ\.huəl
បង្ហួស	ɓɑŋ\.huəh
បង្ហើប	ɓɑŋ\.haəp
បង្ហើម	ɓɑŋ\.haəm
បង្ហើយ	ɓɑŋ\.haəj
បង្ហើរ	ɓɑŋ\.haə
បង្ហៀរ	ɓɑŋ\.hiə
បង្ហេវ	ɓɑŋ\.heew
បង្ហែប	ɓɑŋ\.haep
បង្ហែល	ɓɑŋ\.hael
បង្ហោច	ɓɑŋ\.haoc
បង្ហោះ	ɓɑŋ\.hɑh
បង្អង់	ɓɑŋ\.ʔɑŋ
បង្អត់	ɓɑŋ\.ʔɑt
បង្អន់	ɓɑŋ\.ʔɑn
បង្អស់	ɓɑŋ\.ʔɑh
បង្អាច	ɓɑŋ\.ʔaac
បង្អុរ	ɓɑŋ\.ʔo
បង្អូន	ɓɑŋ\.ʔoon
បង្អូស	ɓɑŋ\.ʔooh
បង្អួច	ɓɑŋ\.ʔuəc
បង្អួត	ɓɑŋ\.ʔuət
បង្អួល	ɓɑŋ\.ʔuəl
បង្អើត	ɓɑŋ\.ʔaət
បង្អើល	ɓɑŋ\.ʔaəl
បង្អៀង	ɓɑŋ\.ʔiəŋ
បង្អៀន	ɓɑŋ\.ʔiən
បង្អៀវ	ɓɑŋ\.ʔiəw
បង្អែក	ɓɑŋ\.ʔaek
បង្អែន	ɓɑŋ\.ʔaen
បង្អែប	ɓɑŋ\.ʔaep
បង្អែម	ɓɑŋ\.ʔaem
បង្អោង	ɓɑŋ\.ʔaoŋ
បង្អោត	ɓɑŋ\.ʔaot
បង្អោន	ɓɑŋ\.ʔaon
បង្អោរ	ɓɑŋ\.ʔao
បញ្ចង់	ɓɑɲ\.cɑŋ
បញ្ចប់	ɓɑɲ\.cɑp
បញ្ចាំ	ɓɑɲ\.cam
បញ្ចុក	ɓɑɲ\.cok
បញ្ចុះ	ɓɑɲ\.coh
បញ្ចូល	ɓɑɲ\.cool
បញ្ចើច	ɓɑɲ\.caəc
បញ្ចៀស	ɓɑɲ\.ciəh
បញ្ចេញ	ɓɑɲ\.ceeɲ
បញ្ចេរ	ɓɑɲ\.cee
បញ្ចេះ	ɓɑɲ\.ceh
បញ្ចោរ	ɓɑɲ\.cao
បញ្ឆាក	ɓɑɲ\.cʰaak
បញ្ឆាប	ɓɑɲ\.cʰaap
បញ្ឆិច	ɓɑɲ\.cʰəc
បញ្ឆិត	ɓɑɲ\.cʰət
បញ្ឆឹក	ɓɑɲ\.cʰək
បញ្ឆុក	ɓɑɲ\.cʰok
បញ្ឆួល	ɓɑɲ\.cʰuəl
បញ្ឆើត	ɓɑɲ\.cʰaət
បញ្ឆៀង	ɓɑɲ\.cʰiəŋ
បញ្ឆេះ	ɓɑɲ\.cʰeh
បញ្ឆោត	ɓɑɲ\.cʰaot
បញ្ជក់	ɓɑɲ\.cuək
បញ្ជច់	ɓɑɲ\.cuc
បញ្ជល់	ɓɑɲ\.cul
បញ្ជិះ	ɓɑɲ\.cih
បញ្ជូន	ɓɑɲ\.cuun
បញ្ជើច	ɓɑɲ\.cəəc
បញ្ជោក	ɓɑɲ\.cook
បញ្ជោរ	ɓɑɲ\.coo
បញ្ជោះ	ɓɑɲ\.cuəh
បញ្ឈប់	ɓɑɲ\.cʰup
បញ្ឈែល	ɓɑɲ\.cʰɛɛl
បញ្ញែម	ɓɑɲ\.ɲaem
បណ្ដាញ	ɓɑn\.ɗaaɲ
បណ្ដាល	ɓɑn\.ɗaal
បណ្ដាំ	ɓɑn\.ɗam
បណ្ដិប	ɓɑn\.ɗəp
បណ្ដឹង	ɓɑn\.ɗəŋ
បណ្ដឹប	ɓɑn\.ɗəp
បណ្ដុន	ɓɑn\.ɗon
បណ្ដុំ	ɓɑn\.ɗom
បណ្ដុះ	ɓɑn\.ɗoh
បណ្ដូល	ɓɑn\.ɗool
បណ្ដើរ	ɓɑn\.ɗaə
បណ្ដេញ	ɓɑn\.ɗeeɲ
បណ្ដែត	ɓɑn\.ɗaet
បណ្ដោយ	ɓɑn\.ɗaoj
បណ្ដោះ	ɓɑn\.ɗɑh
បន្តក់	ɓɑn\.tɑk
បន្តិច	ɓɑn\.təc
បន្តឹង	ɓɑn\.təŋ
បន្តុប	ɓɑn\.top
បន្តុះ	ɓɑn\.toh
បន្តូច	ɓɑn\.tooc
បន្តួច	ɓɑn\.tuəc
បន្តើត	ɓɑn\.taət
បន្តោក	ɓɑn\.taok
បន្តោង	ɓɑn\.taoŋ
បន្ថុច	ɓɑn\.tʰoc
បន្ថើរ	ɓɑn\.tʰaə
បន្ថែម	ɓɑn\.tʰaem
បន្ថោក	ɓɑn\.tʰaok
បន្ទច់	ɓɑn\.tuc
បន្ទន់	ɓɑn\.tun
បន្ទប់	ɓɑn\.tup
បន្ទាប	ɓɑn\.tiep
បន្ទាយ	ɓɑn\.tiej
បន្ទារ	ɓɑn\.tie
បន្ទាល	ɓɑn\.tiel
បន្ទាស	ɓɑn\.tieh
បន្ទីង	ɓɑn\.tiiŋ
បន្ទុក	ɓɑn\.tuk
បន្ទុល	ɓɑn\.tul
បន្ទុំ	ɓɑn\.tum
បន្ទូល	ɓɑn\.tuul
បន្ទើង	ɓɑn\.təəŋ
បន្ទើត	ɓɑn\.təət
បន្ទើរ	ɓɑn\.təə
បន្ទេរ	ɓɑn\.tee
បន្ទោស	ɓɑn\.tooh
បន្ទោះ	ɓɑn\.tuəh
បន្ធូរ	ɓɑn\.tʰuu
បន្លប់	ɓɑn\.lɑp
បន្លាច	ɓɑn\.laac
បន្លាយ	ɓɑn\.laaj
បន្លិច	ɓɑn\.ləc
បន្លឹម	ɓɑn\.ləm
បន្លុក	ɓɑn\.lok
បន្លុង	ɓɑn\.loŋ
បន្លុយ	ɓɑn\.loj
បន្លួញ	ɓɑn\.luəɲ
បន្លៀក	ɓɑn\.liək
បន្លៀន	ɓɑn\.liən
បន្លែង	ɓɑn\.laeŋ
បន្លោះ	ɓɑn\.lɑh
បន្សល់	ɓɑn\.sɑl
បន្សាប	ɓɑn\.saap
បន្សារ	ɓɑn\.saa
បន្សាំ	ɓɑn\.sam
បន្សើច	ɓɑn\.saəc
បន្សើម	ɓɑn\.saəm
បន្សោះ	ɓɑn\.sɑh
បន្ស៊ី	ɓɑn\.sii
បម្រាប	ɓɑm\.raap
បម្រាម	ɓɑm\.raam
បម្រាស	ɓɑm\.raah
បម្រឹង	ɓɑm\.rəŋ
បម្រុង	ɓɑm\.roŋ
បម្រោស	ɓɑm\.raoh
បំណាក់	ɓɑm\.nak
បំណាច់	ɓɑm\.nac
បំណាត់	ɓɑm\.nat
បំបាក់	ɓɑm\.ɓak
បំបាត់	ɓɑm\.ɓat
បំបាំង	ɓɑm\.ɓaŋ
បំប៉ឹម	ɓɑm\.pəm
បំប៉ោង	ɓɑm\.paoŋ
បំពាក់	ɓɑm\.peak
បំពាំង	ɓɑm\.peaŋ
បំព្រង	ɓɑm\.prɔɔŋ
បំព្រៃ	ɓɑm\.prej
បំព្រំ	ɓɑm\.prum
បំភាន់	ɓɑm\.pʰoan
បំភ្លឺ	ɓɑm\.plɨɨ
បំភ្លៃ	ɓɑm\.plej
ប៉ប៉ប់	pɑ\.pɑp
ប៉ប៉ិច	pɑ\.pəc
ប៉ប៉ិល	pɑ\.pəl
ប៉ប៉ុក	pɑ\.pok
ប៉ប៉ុប	pɑ\.pop
ប៉ប៉ែះ	pɑ\.paeh
ប៉ប៉ោច	pɑ\.paoc
ប៉ប្រក	pɑ\.prɑɑk
ប៉ប្រង	pɑ\.prɑɑŋ
ប៉ប្រច	pɑ\.prɑɑc
ប៉ប្រស	pɑ\.prɑɑh
ប៉ប្រៃ	pɑ\.praj
ប៉ប្រះ	pɑ\.prah
ប៉ផាប់	pɑ\.pʰap
ប្រកល់	prɑ\.kɑl
ប្រការ	prɑ\.kaa
ប្រកាំ	prɑ\.kam
ប្រកិត	prɑ\.kət
ប្រកឹង	prɑ\.kəŋ
ប្រកុន	prɑ\.kon
ប្រកុំ	prɑ\.kom
ប្រកួត	prɑ\.kuət
ប្រកើយ	prɑ\.kaəj
ប្រកៀក	prɑ\.kiək
ប្រកៀង	prɑ\.kiəŋ
ប្រកែក	prɑ\.kaek
ប្រកោះ	prɑ\.kɑh
ប្រខាំ	prɑ\.kʰam
ប្រខុប	prɑ\.kʰop
ប្រគល់	prɑ\.kul
ប្រគាប	prɑ\.kiep
ប្រគេន	prɑ\.keen
ប្រចាំ	prɑ\.cam
ប្រចឹក	prɑ\.cək
ប្រចុប	prɑ\.cop
ប្រចួន	prɑ\.cuən
ប្រចួប	prɑ\.cuəp
ប្រចៀច	prɑ\.ciəc
ប្រចៀវ	prɑ\.ciəw
ប្រចែង	prɑ\.caeŋ
ប្រចោម	prɑ\.caom
ប្រឆេះ	prɑ\.cʰeh
ប្រជុំ	prɑ\.cum
ប្រជួន	prɑ\.cuən
ប្រជួប	prɑ\.cuəp
ប្រជួស	prɑ\.cuəh
ប្រជៀច	prɑ\.ciəc
ប្រជៀវ	prɑ\.ciəw
ប្រជែង	prɑ\.cɛɛŋ
ប្រឈួន	prɑ\.cʰuən
ប្រញាយ	prɑ\.ɲaaj
ប្រញិប	prɑ\.ɲəp
ប្រញឹក	prɑ\.ɲək
ប្រដក់	prɑ\.ɗɑk
ប្រដាញ	prɑ\.ɗaaɲ
ប្រដិត	prɑ\.ɗət
ប្រដឹស	prɑ\.ɗəh
ប្រដឺត	prɑ\.ɗəət
ប្រដូច	prɑ\.ɗooc
ប្រដើស	prɑ\.ɗaəh
ប្រដេញ	prɑ\.ɗeeɲ
ប្រដោត	prɑ\.ɗaot
ប្រដោល	prɑ\.ɗaol
ប្រណាក	prɑ\.naak
ប្រណិត	prɑ\.nət
ប្រតប់	prɑ\.tɑp
ប្រតាក	prɑ\.taak
ប្រតាយ	prɑ\.taaj
ប្រតេក	prɑ\.teek
ប្រតែង	prɑ\.taeŋ
ប្រតោក	prɑ\.taok
ប្រតោង	prɑ\.taoŋ
ប្រថាន	prɑ\.tʰaan
ប្រថុច	prɑ\.tʰoc
ប្រថុយ	prɑ\.tʰoj
ប្រថួន	prɑ\.tʰuən
ប្រទង់	prɑ\.tuŋ
ប្រទល់	prɑ\.tul
ប្រទាញ	prɑ\.tieɲ
ប្រទាល	prɑ\.tiel
ប្រទាស	prɑ\.tieh
ប្រទើស	prɑ\.təəh
ប្រទេច	prɑ\.teec
ប្រទេស	prɑ\.teeh
ប្រធួន	prɑ\.tʰuən
ប្រនៀល	prɑ\.niəl
ប្របិច	prɑ\.ɓəc
ប្របៀត	prɑ\.ɓiət
ប្របេរ	prɑ\.ɓee
ប្របេះ	prɑ\.ɓeh
ប្របែក	prɑ\.ɓaek
ប្របែល	prɑ\.ɓael
ប្របោច	prɑ\.ɓaoc
ប្រផង់	prɑ\.pʰɑŋ
ប្រផុត	prɑ\.pʰot
ប្រផូរ	prɑ\.pʰoo
ប្រផេញ	prɑ\.pʰeeɲ
ប្រផេះ	prɑ\.pʰeh
ប្រពាន	prɑ\.pien
ប្រពាយ	prɑ\.piej
ប្រពាស	prɑ\.pieh
ប្រពូន	prɑ\.puun
ប្រភើច	prɑ\.pʰəəc
ប្រមង់	prɑ\.mɑŋ
ប្រមល់	prɑ\.mɑl
ប្រមឹក	prɑ\.mək
ប្រមុច	prɑ\.moc
ប្រមុញ	prɑ\.moɲ
ប្រមុម	prɑ\.mom
ប្រមុំ	prɑ\.mom
ប្រមូរ	prɑ\.moo
ប្រមូល	prɑ\.mool
ប្រមើល	prɑ\.maəl
ប្រមៀល	prɑ\.miəl
ប្រមោក	prɑ\.maok
ប្រមោយ	prɑ\.maoj
ប្រយែង	prɑ\.jaeŋ
ប្រយោល	prɑ\.jaol
ប្រលង់	prɑ\.lɑŋ
ប្រលូក	prɑ\.look
ប្រលូញ	prɑ\.looɲ
ប្រលូស	prɑ\.looh
ប្រលេះ	prɑ\.leh
ប្រលែង	prɑ\.laeŋ
ប្រលោះ	prɑ\.lɑh
ប្រវាយ	prɑ\.waaj
ប្រវាល	prɑ\.waal
ប្រវឹក	prɑ\.wək
ប្រវែង	prɑ\.waeŋ
ប្រសប់	prɑ\.sɑp
ប្រសាច	prɑ\.saac
ប្រសេច	prɑ\.seec
ប្រហប់	prɑ\.hɑp
ប្រហាត	prɑ\.haat
ប្រហិត	prɑ\.hət
ប្រហុក	prɑ\.hok
ប្រហួរ	prɑ\.huə
ប្រហើរ	prɑ\.haə
ប្រហេត	prɑ\.heet
ប្រហែក	prɑ\.haek
ប្រហែង	prɑ\.haeŋ
ប្រហែស	prɑ\.haeh
ប្រហោង	prɑ\.haoŋ
ប្រឡង់	prɑ\.lɑŋ
ប្រឡាយ	prɑ\.laaj
ប្រឡូក	prɑ\.look
ប្រឡូញ	prɑ\.looɲ
ប្រឡូស	prɑ\.looh
ប្រឡេះ	prɑ\.leh
ប្រឡែង	prɑ\.laeŋ
ប្រឡោះ	prɑ\.lɑh
ប្រអប់	prɑ\.ʔɑp
ប្រអូង	prɑ\.ʔooŋ
ប្រអូស	prɑ\.ʔooh
ប្រអួល	prɑ\.ʔuəl
ប្រាក់	prak
ប្រាច់	prac
ប្រាត់	prat
ប្រាប់	prap
ប្រាស់	prah
ប្រាំង	praŋ
ប្លាច់	plac
ប្លាប់	plap
ប្អ៊ឹះ	pʔɨh
ផល្គុន	pʰɑ\.lkun
ផ្កាប់	pkap
ផ្គាក់	pkeak
ផ្គាប់	pkoap
ផ្ចាច់	pcac
ផ្ចាញ់	pcaɲ
ផ្ចាប់	pcap
ផ្ញាច់	pɲac
ផ្ដាច់	pɗac
ផ្ទាត់	ptoat
ផ្ទាន់	ptoan
ផ្ទាប់	ptoap
ផ្ទាល់	ptoal
ផ្ទាំង	pteaŋ
ផ្លាប់	plap
ផ្លាស់	plah
ផ្សាំង	psaŋ
ផ្ស៊ាំ	psoam
ផ្អាប់	pʔap
ពង្រត់	puŋ\.rut
ពង្រាក	puŋ\.riek
ពង្រាង	puŋ\.rieŋ
ពង្រាប	puŋ\.riep
ពង្រាយ	puŋ\.riej
ពង្រាល	puŋ\.riel
ពង្រីក	puŋ\.riik
ពង្រីង	puŋ\.riiŋ
ពង្រឹង	puŋ\.rɨŋ
ពង្រឹត	puŋ\.rɨt
ពង្រឹល	puŋ\.rɨl
ពង្រុល	puŋ\.rul
ពង្រូង	puŋ\.ruuŋ
ពង្រូល	puŋ\.ruul
ពង្រួប	puŋ\.ruəp
ពង្រួម	puŋ\.ruəm
ពង្រេច	puŋ\.reec
ពង្រោះ	puŋ\.ruəh
ពង្វក់	puŋ\.wuək
ពង្វាង	puŋ\.wieŋ
ពង្វាត	puŋ\.wiet
ពង្វិល	puŋ\.wɨl
ពង្វឹក	puŋ\.wɨk
ពង្វៀន	puŋ\.wiən
ពង្វៀះ	puŋ\.wiəh
ពង្វេះ	puŋ\.weh
ពន្យល់	pun\.jul
ពន្យារ	pun\.jie
ពន្យឺត	pun\.jɨɨt
ពន្យឺន	pun\.jɨɨn
ពន្យុយ	pun\.juj
ពន្យុល	pun\.jul
ពន្យុះ	pun\.juh
ពន្យូយ	pun\.juuj
ពន្យោល	pun\.jool
ពន្រាយ	pun\.riej
ពន្លង់	pun\.luŋ
ពន្លត់	pun\.lut
ពន្លាក	pun\.liek
ពន្លាញ	pun\.lieɲ
ពន្លិច	pun\.lɨc
ពន្លឹក	pun\.lɨk
ពន្លឹប	pun\.lɨp
ពន្លុង	pun\.luŋ
ពន្លុត	pun\.lut
ពន្លុន	pun\.lun
ពន្លូក	pun\.luuk
ពន្លូច	pun\.luuc
ពន្លូត	pun\.luut
ពន្លូន	pun\.luun
ពន្លួញ	pun\.luəɲ
ពន្លើស	pun\.ləəh
ពន្លឿន	pun\.lɨən
ពន្លៀក	pun\.liək
ពន្លៀន	pun\.liən
ពន្លែង	pun\.lɛɛŋ
ពន្លោត	pun\.loot
ពព្រាត	pɔ\.priet
ពព្រាយ	pɔ\.priej
ពព្រិច	pɔ\.prɨc
ពព្រឹម	pɔ\.prɨm
ពព្រឹល	pɔ\.prɨl
ពព្រឺស	pɔ\.prɨɨh
ពព្រុស	pɔ\.pruh
ពព្រូស	pɔ\.pruuh
ពព្រួក	pɔ\.pruək
ពព្រួច	pɔ\.pruəc
ពព្រើត	pɔ\.prəət
ពព្រើម	pɔ\.prəəm
ពព្រើស	pɔ\.prəəh
ពព្រៀក	pɔ\.priək
ពព្រៀប	pɔ\.priəp
ពព្លែម	pɔ\.plɛɛm
ពភ្លក់	pɔ\.pluək
ពភ្លាម	pɔ\.pliem
ពភ្លឹម	pɔ\.plɨm
ពភ្លឹះ	pɔ\.plɨh
ពភ្លុក	pɔ\.pluk
ពភ្លុង	pɔ\.pluŋ
ពភ្លួក	pɔ\.pluək
ពភ្លើក	pɔ\.pləək
ពភ្លៀក	pɔ\.pliək
ពភ្លែត	pɔ\.plɛɛt
ពភ្លែល	pɔ\.plɛɛl
ពភ្លែះ	pɔ\.plɛh
ពំនាក់	pum\.neak
ព្រងើយ	prɔ\.ŋəəj
ព្រញូញ	prɔ\.ɲuuɲ
ព្រនង់	prɔ\.nuŋ
ព្រនួត	prɔ\.nuət
ព្រមត់	prɔ\.mut
ព្រមាន	prɔ\.mien
ព្រមឹក	prɔ\.mɨk
ព្រយឺត	prɔ\.jɨɨt
ព្រយុង	prɔ\.juŋ
ព្រយោង	prɔ\.jooŋ
ព្ររឹត	prɔ\.rɨt
ព្ររួត	prɔ\.ruət
ព្រលប់	prɔ\.lup
ព្រលាំ	prɔ\.loam
ព្រលិង	prɔ\.lɨŋ
ព្រលិត	prɔ\.lɨt
ព្រលីត	prɔ\.liit
ព្រលីស	prɔ\.liih
ព្រលឹង	prɔ\.lɨŋ
ព្រលឹត	prɔ\.lɨt
ព្រលឹម	prɔ\.lɨm
ព្រលូង	prɔ\.luuŋ
ព្រលូញ	prɔ\.luuɲ
ព្រលូស	prɔ\.luuh
ព្រលែត	prɔ\.lɛɛt
ព្រវារ	prɔ\.wie
ព្រវឹង	prɔ\.wɨŋ
ព្រវែក	prɔ\.wɛɛk
ព្រហក់	prɔ\.hɑk
ព្រហាម	prɔ\.haam
ព្រហីត	prɔ\.həjt
ព្រហូត	prɔ\.hoot
ព្រហួញ	prɔ\.huəɲ
ព្រហួម	prɔ\.huəm
ព្រហើន	prɔ\.haən
ព្រហែត	prɔ\.haet
ព្រអូញ	prɔ\.ʔooɲ
ព្រាត់	proat
ភ្ជាប់	pcoap
ភ្ញាក់	pɲeak
ភ្ញាស់	pɲoah
ភ្នាល់	pnoal
ភ្លាត់	ploat
ភ្លាំង	pleaŋ
មង្ឃុត	muŋ\.kʰut
មន្ទិល	mun\.tɨl
មន្ទីរ	mun\.tii
ម្កាក់	mkak
ម្ចាក់	mcak
ម្ចាស់	mcah
ម្នាស់	mnoah
ម្យ៉ាង	mjaaŋ
ម្រាក់	mreak
ម្លាន់	mloan
ម្ល៉ឹង	mləŋ
ម្ល៉េះ	mleh
ម្សាញ់	msaɲ
ម្ហ៊ិះ	mhih
ម្ហ៊ែត	mhɛɛt
រង្កៀក	ruŋ\.kiək
រង្កៀស	ruŋ\.kiəh
រង្គាល	ruŋ\.kiel
រង្គើក	ruŋ\.kəək
រង្គោះ	ruŋ\.kuəh
រង្វង់	ruŋ\.wuŋ
រង្វឹង	ruŋ\.wɨŋ
រង្វើល	ruŋ\.wəəl
រង្វេល	ruŋ\.weel
រញ៉ាល់	rɔ\.ɲal
រញ្ជួយ	ruɲ\.cuəj
រណ្ដាស	run\.ɗaah
រន្ទាល	run\.tiel
រន្ទេប	run\.teep
រន្ធត់	run\.tʰut
រម្ងាច	rum\.ŋiec
រម្ងើក	rum\.ŋəək
រម្តោះ	rum\.tɑh
រម្លត់	rum\.lut
រម្លប់	rum\.lup
រម្លស់	rum\.luəh
រម្លាក	rum\.liek
រម្លាយ	rum\.liej
រម្លីង	rum\.liiŋ
រម្លឹក	rum\.lɨk
រម្លុប	rum\.lup
រម្លុះ	rum\.luh
រម្លូត	rum\.luut
រម្លើង	rum\.ləəŋ
រម្លោក	rum\.look
រម្សាយ	rum\.saaj
រម្ហាច	rum\.haac
រម្ហូត	rum\.hoot
រម្ហើយ	rum\.haəj
រម្អិល	rum\.ʔəl
រម្អែង	rum\.ʔaeŋ
រវ៉ាច់	rɔ\.wac
រំកាច់	rum\.kac
រំងាប់	rum\.ŋoap
រំងាស់	rum\.ŋoah
រំប៉ើក	rum\.paək
រំពាត់	rum\.poat
រំពាស់	rum\.poah
លង្វែក	luŋ\.wɛɛk
លង្ហិន	luŋ\.hən
លន្លង់	lun\.luŋ
លន្លាម	lun\.liem
លន្លឹម	lun\.lɨm
លន្លោច	lun\.looc
លម្ហាច	lum\.haac
លម្ហើយ	lum\.haəj
លម្អក់	lum\.ʔɑk
លម្អន់	lum\.ʔɑn
លម្អាន	lum\.ʔaan
លម្អិត	lum\.ʔət
លម្អៀង	lum\.ʔiəŋ
លំដាប់	lum\.ɗap
លំពាន់	lum\.poan
លំពាស់	lum\.poah
លំពាំង	lum\.peaŋ
ល្ងាន់	lŋoan
ល្បាក់	lɓak
ល្បាប់	lɓap
ល្បាស់	lɓah
ល្មាក់	lmeak
ល្មាំង	lmeaŋ
ល្អាច់	lʔac
វង្វេង	wuŋ\.weeŋ
វរ្មិត	wɔ\.rmɨt
សង្កល់	sɑŋ\.kɑl
សង្កិន	sɑŋ\.kən
សង្កិម	sɑŋ\.kəm
សង្កឹម	sɑŋ\.kəm
សង្កួត	sɑŋ\.kuət
សង្កើច	sɑŋ\.kaəc
សង្កៀត	sɑŋ\.kiət
សង្កៀរ	sɑŋ\.kiə
សង្ខុញ	sɑŋ\.kʰoɲ
សង្ឃឹក	sɑŋ\.kʰɨk
សង្ឃឹម	sɑŋ\.kʰɨm
សង្រេង	sɑŋ\.reeŋ
សង្រែក	sɑŋ\.raek
សង្វាត	sɑŋ\.waat
សង្វារ	sɑŋ\.waa
សង្វិត	sɑŋ\.wət
សង្វិល	sɑŋ\.wəl
សង្វៀន	sɑŋ\.wiən
សង្វែង	sɑŋ\.waeŋ
សង្វោយ	sɑŋ\.waoj
សង្អន់	sɑŋ\.ʔɑn
សង្អារ	sɑŋ\.ʔaa
សញ្ជប់	sɑɲ\.cup
សញ្ជឹង	sɑɲ\.cɨŋ
សញ្ជែក	sɑɲ\.cɛɛk
សណ្ដង់	sɑn\.ɗɑŋ
សណ្ដាយ	sɑn\.ɗaaj
សណ្ដូក	sɑn\.ɗook
សណ្ដូន	sɑn\.ɗoon
សណ្ដែក	sɑn\.ɗaek
សណ្ដោង	sɑn\.ɗaoŋ
សត្រូវ	sɑ\.troow
សន្ទង់	sɑn\.tuŋ
សន្ទុះ	sɑn\.tuh
សន្ទូង	sɑn\.tuuŋ
សន្ទូច	sɑn\.tuuc
សន្ទេះ	sɑn\.teh
សន្ធប់	sɑn\.tʰup
សន្ធឹក	sɑn\.tʰɨk
សន្ធឹង	sɑn\.tʰɨŋ
សន្លង់	sɑn\.lɑŋ
សន្លប់	sɑn\.lɑp
សន្លាង	sɑn\.laaŋ
សន្លិន	sɑn\.lən
សន្លឹក	sɑn\.lək
សន្លឹង	sɑn\.ləŋ
សន្លឹម	sɑn\.ləm
សន្លុង	sɑn\.loŋ
សន្សឹម	sɑn\.səm
សន្សើម	sɑn\.saəm
សម្កាក	sɑm\.kaak
សម្កុង	sɑm\.koŋ
សម្កុល	sɑm\.kol
សម្កូញ	sɑm\.kooɲ
សម្កូវ	sɑm\.koow
សម្គុល	sɑm\.kul
សម្គោក	sɑm\.kook
សម្ងាច	sɑm\.ŋaac
សម្ងើច	sɑm\.ŋaəc
សម្ញាញ	sɑm\.ɲaaɲ
សម្ញេញ	sɑm\.ɲeeɲ
សម្ញែង	sɑm\.ɲaeŋ
សម្ដឹង	sɑm\.ɗəŋ
សម្ដឺត	sɑm\.ɗəət
សម្ដើង	sɑm\.ɗaəŋ
សម្ដេច	sɑm\.ɗeec
សម្ដេជ	sɑm\.ɗeec
សម្ដែង	sɑm\.ɗaeŋ
សម្ដោះ	sɑm\.ɗɑh
សម្តុល	sɑm\.tol
សម្តោក	sɑm\.taok
សម្ទក់	sɑm\.tuək
សម្ទង់	sɑm\.tuŋ
សម្ទាញ	sɑm\.tieɲ
សម្ទារ	sɑm\.tie
សម្ទីក	sɑm\.tiik
សម្ទុះ	sɑm\.tuh
សម្ទូង	sɑm\.tuuŋ
សម្ទើញ	sɑm\.təəɲ
សម្ទេះ	sɑm\.teh
សម្ទែល	sɑm\.tɛɛl
សម្នាម	sɑm\.naam
សម្បារ	sɑm\.ɓaa
សម្បុក	sɑm\.ɓok
សម្បុដ	sɑm\.ɓot
សម្បុរ	sɑm\.ɓo
សម្បួរ	sɑm\.ɓuə
សម្បើម	sɑm\.ɓaəm
សម្បែង	sɑm\.ɓaeŋ
សម្បោរ	sɑm\.ɓao
សម្ពាយ	sɑm\.piej
សម្ពឹក	sɑm\.pɨk
សម្ពៀត	sɑm\.piət
សម្ពែះ	sɑm\.pɛh
សម្ភេទ	sɑm\.pʰeet
សម្ភោគ	sɑm\.pʰook
សម្ភោរ	sɑm\.pʰoo
សម្រក់	sɑm\.rɑk
សម្រង់	sɑm\.rɑŋ
សម្រន់	sɑm\.rɑn
សម្រស់	sɑm\.rɑh
សម្រាក	sɑm\.raak
សម្រាត	sɑm\.raat
សម្រាយ	sɑm\.raaj
សម្រាល	sɑm\.raal
សម្រិត	sɑm\.rət
សម្រិល	sɑm\.rəl
សម្រឹង	sɑm\.rəŋ
សម្រុក	sɑm\.rok
សម្រុង	sɑm\.roŋ
សម្រុញ	sɑm\.roɲ
សម្រុត	sɑm\.rot
សម្រុះ	sɑm\.roh
សម្រូត	sɑm\.root
សម្រូប	sɑm\.roop
សម្រួច	sɑm\.ruəc
សម្រួត	sɑm\.ruət
សម្រួល	sɑm\.ruəl
សម្រើប	sɑm\.raəp
សម្រៀម	sɑm\.riəm
សម្រេក	sɑm\.reek
សម្រេង	sɑm\.reeŋ
សម្រេច	sɑm\.reec
សម្រេះ	sɑm\.reh
សម្រែក	sɑm\.raek
សម្រែង	sɑm\.raeŋ
សម្រោច	sɑm\.raoc
សម្រោប	sɑm\.raop
សម្រោះ	sɑm\.rɑh
សម្លក់	sɑm\.lɑk
សម្លាក	sɑm\.laak
សម្លិច	sɑm\.ləc
សម្លឹង	sɑm\.ləŋ
សម្លុក	sɑm\.lok
សម្លុត	sɑm\.lot
សម្លុយ	sɑm\.loj
សម្លូត	sɑm\.loot
សម្លើត	sɑm\.laət
សម្លេក	sɑm\.leek
សម្លេច	sɑm\.leec
សម្លេះ	sɑm\.leh
សម្លែវ	sɑm\.laew
សម្អប់	sɑm\.ʔɑp
សម្អាង	sɑm\.ʔaaŋ
សម្អាត	sɑm\.ʔaat
សម្អិត	sɑm\.ʔət
សម្អុយ	sɑm\.ʔoj
សម្អេក	sɑm\.ʔeek
សម្អែល	sɑm\.ʔael
សស្រាំ	sɑ\.sram
សស្រិក	sɑ\.srək
សស្រិច	sɑ\.srəc
សស្រិប	sɑ\.srəp
សស្រឹប	sɑ\.srəp
សស្រូស	sɑ\.srooh
សស្រូះ	sɑ\.srooh
សស្រួញ	sɑ\.sruəɲ
សស្រោក	sɑ\.sraok
សស្លក់	sɑ\.slɑk
សស្លើត	sɑ\.slaət
សំកាំង	sɑm\.kaŋ
សំខាន់	sɑm\.kʰan
សំគាល់	sɑm\.koal
សំគាំង	sɑm\.keaŋ
សំងាត់	sɑm\.ŋat
សំណាក់	sɑm\.nak
សំណាញ់	sɑm\.naɲ
សំណាត់	sɑm\.nat
សំបាច់	sɑm\.ɓac
សំប៉ាត	sɑm\.paat
សំប៉ាន	sɑm\.paan
សំប៉ែត	sɑm\.paet
សំព្រោ	sɑm\.proo
ស្កាត់	skat
ស្គាក់	skeak
ស្គាល់	skoal
ស្គាំង	skeaŋ
ស្ងាត់	sŋat
ស្ដាប់	sɗap
ស្ទាក់	steak
ស្ទាត់	stoat
ស្ទាល់	stoal
ស្ទាំង	steaŋ
ស្នាប់	snap
ស្បាត់	sɓat
ស្បាន់	sɓan
ស្ប៉ឹម	spəm
ស្ប៉ុរ	spo
ស្ប៉ែត	spaet
ស្ពាន់	spoan
ស្មាច់	smac
ស្មាន់	sman
ស្រកក់	srɑ\.kɑk
ស្រកាក	srɑ\.kaak
ស្រកូក	srɑ\.kook
ស្រកេក	srɑ\.keek
ស្រកោក	srɑ\.kaok
ស្រខក់	srɑ\.kʰɑk
ស្រខូវ	srɑ\.kʰoow
ស្រគាល	srɑ\.kiel
ស្រគាំ	srɑ\.koam
ស្រគុក	srɑ\.kuk
ស្រគុល	srɑ\.kul
ស្រគែល	srɑ\.kɛɛl
ស្រគោម	srɑ\.koom
ស្រឃុល	srɑ\.kʰul
ស្រងល់	srɑ\.ŋɑl
ស្រងាក	srɑ\.ŋaak
ស្រងាំ	srɑ\.ŋam
ស្រងឹម	srɑ\.ŋəm
ស្រងូត	srɑ\.ŋoot
ស្រងៀវ	srɑ\.ŋiəw
ស្រងេវ	srɑ\.ŋeew
ស្រងោច	srɑ\.ŋaoc
ស្រជែត	srɑ\.cɛɛt
ស្រដៀង	srɑ\.ɗiəŋ
ស្រណាង	srɑ\.naaŋ
ស្រណាន	srɑ\.naan
ស្រណុក	srɑ\.nok
ស្រណោក	srɑ\.naok
ស្រណោះ	srɑ\.nɑh
ស្រតឹក	srɑ\.tək
ស្រតូវ	srɑ\.toow
ស្រទន់	srɑ\.tun
ស្រទាង	srɑ\.tieŋ
ស្រទៀក	srɑ\.tiək
ស្របក់	srɑ\.ɓɑk
ស្របាល	srɑ\.ɓaal
ស្រពន់	srɑ\.pun
ស្រពាប	srɑ\.piep
ស្រពិល	srɑ\.pɨl
ស្រពោន	srɑ\.poon
ស្រមាញ	srɑ\.maaɲ
ស្រមាម	srɑ\.maam
ស្រមិក	srɑ\.mək
ស្រមឹម	srɑ\.məm
ស្រមុក	srɑ\.mok
ស្រមុយ	srɑ\.moj
ស្រមូញ	srɑ\.mooɲ
ស្រមូម	srɑ\.moom
ស្រមូល	srɑ\.mool
ស្រមូវ	srɑ\.moow
ស្រមើង	srɑ\.maəŋ
ស្រមើល	srɑ\.maəl
ស្រមៀន	srɑ\.miən
ស្រមេក	srɑ\.meek
ស្រមេម	srɑ\.meem
ស្រមេវ	srɑ\.meew
ស្រមេះ	srɑ\.meh
ស្រមោច	srɑ\.maoc
ស្រមោល	srɑ\.maol
ស្រយង់	srɑ\.jɑŋ
ស្រយាក	srɑ\.jaak
ស្រយាល	srɑ\.jaal
ស្រយាវ	srɑ\.jaaw
ស្រយឺល	srɑ\.jəəl
ស្រយុត	srɑ\.jot
ស្រយូវ	srɑ\.joow
ស្រយើល	srɑ\.jaəl
ស្រលាប	srɑ\.laap
ស្រលិត	srɑ\.lət
ស្រលឹង	srɑ\.ləŋ
ស្រលឹប	srɑ\.ləp
ស្រលុង	srɑ\.loŋ
ស្រលូង	srɑ\.looŋ
ស្រលួត	srɑ\.luət
ស្រលួន	srɑ\.luən
ស្រលៀង	srɑ\.liəŋ
ស្រលេញ	srɑ\.leeɲ
ស្រលេត	srɑ\.leet
ស្រលេវ	srɑ\.leew
ស្រលែវ	srɑ\.laew
ស្រវឹង	srɑ\.wəŋ
ស្រវើន	srɑ\.waən
ស្រឡក់	srɑ\.lɑk
ស្រឡប់	srɑ\.lɑp
ស្រឡាង	srɑ\.laaŋ
ស្រឡាប	srɑ\.laap
ស្រឡិត	srɑ\.lət
ស្រឡឹង	srɑ\.ləŋ
ស្រឡឹប	srɑ\.ləp
ស្រឡុង	srɑ\.loŋ
ស្រឡូង	srɑ\.looŋ
ស្រឡេត	srɑ\.leet
ស្រឡេវ	srɑ\.leew
ស្រឡែវ	srɑ\.laew
ស្រឡោច	srɑ\.laoc
ស្រអិប	srɑ\.ʔəp
ស្រអែត	srɑ\.ʔaet
ស្រអែម	srɑ\.ʔaem
ស្រាក់	srak
ស្រាប់	srap
ស្រាល់	sral
ស្រាស់	srah
ស្រាំង	sraŋ
ស្រ៊ឹង	srɨŋ
ស្រ៊ឹប	srɨp
ស្រ៊ុច	sruc
ស្រ៊ុប	srup
ស្រ៊ូស	sruuh
ស្លាក់	slak
ស្លាប់	slap
ស្លាំង	slaŋ
ស្វាក់	swak
ស្អាប់	sʔap
ហស្ដិន	hɑ\.sɗən
ហហ្មុក	hɑ\.hmok
ហ្នាំង	hnaŋ
ហ្លាក់	hlak
ហ្វ៊ីល	hwiil
អង្កត់	ʔɑŋ\.kɑt
អង្កាម	ʔɑŋ\.kaam
អង្កាំ	ʔɑŋ\.kam
អង្កឹក	ʔɑŋ\.kək
អង្កឺល	ʔɑŋ\.kəəl
អង្កុក	ʔɑŋ\.kok
អង្កុញ	ʔɑŋ\.koɲ
អង្កុល	ʔɑŋ\.kol
អង្កួច	ʔɑŋ\.kuəc
អង្កួញ	ʔɑŋ\.kuəɲ
អង្កើក	ʔɑŋ\.kaək
អង្កៀម	ʔɑŋ\.kiəm
អង្កេត	ʔɑŋ\.keet
អង្កែត	ʔɑŋ\.kaet
អង្គញ់	ʔɑŋ\.kuɲ
អង្គប់	ʔɑŋ\.kup
អង្គាស	ʔɑŋ\.kieh
អង្គុក	ʔɑŋ\.kuk
អង្គុយ	ʔɑŋ\.kuj
អង្គុល	ʔɑŋ\.kul
អង្គើយ	ʔɑŋ\.kəəj
អង្ឃើល	ʔɑŋ\.kʰəəl
អង្រង់	ʔɑŋ\.rɑŋ
អង្រន់	ʔɑŋ\.rɑn
អង្រឹង	ʔɑŋ\.rəŋ
អង្រុត	ʔɑŋ\.rot
អង្រូស	ʔɑŋ\.rooh
អង្រួន	ʔɑŋ\.ruən
អង្វែង	ʔɑŋ\.waeŋ
អង្អែល	ʔɑŋ\.ʔael
អញ្ចាច	ʔɑɲ\.caac
អញ្ចាញ	ʔɑɲ\.caaɲ
អញ្ចាប	ʔɑɲ\.caap
អញ្ចូច	ʔɑɲ\.cooc
អញ្ឆើល	ʔɑɲ\.cʰaəl
អញ្ជុល	ʔɑɲ\.cul
អញ្ជើញ	ʔɑɲ\.cəəɲ
អណ្ដាត	ʔɑn\.ɗaat
អណ្ដូង	ʔɑn\.ɗooŋ
អណ្ដើក	ʔɑn\.ɗaək
អណ្ដើរ	ʔɑn\.ɗaə
អណ្ដែង	ʔɑn\.ɗaeŋ
អណ្ដែត	ʔɑn\.ɗaet
អណ្ដោត	ʔɑn\.ɗaot
អណ្ណាម	ʔɑn\.naam
អធ្យោគ	ʔɑ\.tjook
អន្តាយ	ʔɑn\.taaj
អន្តឺត	ʔɑn\.təət
អន្តុយ	ʔɑn\.toj
អន្តុល	ʔɑn\.tol
អន្ថឺម	ʔɑn\.tʰəəm
អន្ថោច	ʔɑn\.tʰaoc
អន្ទង់	ʔɑn\.tuŋ
អន្ទិល	ʔɑn\.tɨl
អន្ទើត	ʔɑn\.təət
អន្ធិល	ʔɑn\.tʰɨl
អន្ធួម	ʔɑn\.tʰuəm
អន្ធើម	ʔɑn\.tʰəəm
អន្លក់	ʔɑn\.lɑk
អន្លង់	ʔɑn\.lɑŋ
អន្លាយ	ʔɑn\.laaj
អន្លីង	ʔɑn\.ləjŋ
អន្លឹប	ʔɑn\.ləp
អន្លូង	ʔɑn\.looŋ
អន្លូញ	ʔɑn\.looɲ
អប្រិយ	ʔɑ\.prej
អផ្សាន	ʔɑ\.psaan
អម្ចត់	ʔɑm\.cɑt
អម្នេញ	ʔɑm\.neeɲ
អម្បាយ	ʔɑm\.ɓaaj
អម្បាល	ʔɑm\.ɓaal
អម្បូរ	ʔɑm\.ɓoo
អម្បោស	ʔɑm\.ɓaoh
អម្រស់	ʔɑm\.rɑh
អម្រាម	ʔɑm\.raam
អម្រឹត	ʔɑm\.rət
អម្រែក	ʔɑm\.raek
អស្សុជ	ʔɑ\.ssoc
អំប៉ើក	ʔɑm\.paək
អំពាន់	ʔɑm\.poan
អំព្រំ	ʔɑm\.prum
កក្លាក់	kɑ\.klak
កង្វាក់	kɑŋ\.wak
កញ្ចាស់	kɑɲ\.cah
កញ្ចាំង	kɑɲ\.caŋ
កញ្ឆាត់	kɑɲ\.cʰat
កញ្ជាក់	kɑɲ\.ceak
កញ្ជ្រម	kɑɲ\.crɔɔm
កណ្ដាច់	kɑn\.ɗac
កណ្ដាញ់	kɑn\.ɗaɲ
កណ្ដាប់	kɑn\.ɗap
កណ្ដាស់	kɑn\.ɗah
កន្តាំង	kɑn\.taŋ
កន្ត្រង	kɑn\.trɑɑŋ
កន្ត្រៃ	kɑn\.traj
កន្ទ្រម	kɑn\.trɔɔm
កន្ទ្រល	kɑn\.trɔɔl
កន្ធាត់	kɑn\.tʰoat
កន្ធាំង	kɑn\.tʰeaŋ
កន្លាញ់	kɑn\.laɲ
កន្លាស់	kɑn\.lah
កម្ចាត់	kɑm\.cat
កម្ជាប់	kɑm\.coap
កម្រាស់	kɑm\.rah
កម្លាំង	kɑm\.laŋ
កំប្រុក	kɑm\.prok
កំប្រេវ	kɑm\.preew
កំប្រោង	kɑm\.praoŋ
កំប្រោន	kɑm\.praon
កំប្លង់	kɑm\.plɑŋ
កំប្លឹម	kɑm\.pləm
កំប្លុក	kɑm\.plok
កំប្លូច	kɑm\.plooc
កំប្លែង	kɑm\.plaeŋ
កំប្លោក	kɑm\.plaok
កំផ្លឹម	kɑm\.pləm
កំផ្លៀង	kɑm\.pliəŋ
កំផ្លៀវ	kɑm\.pliəw
កំផ្លេស	kɑm\.pleeh
កំព្រឹង	kɑm\.prɨŋ
កំព្រឹស	kɑm\.prɨh
កំព្រើល	kɑm\.prəəl
កំភ្លាញ	kɑm\.plieɲ
កំភ្លឹង	kɑm\.plɨŋ
ក្រចាប់	krɑ\.cap
ក្រញាញ់	krɑ\.ɲaɲ
ក្រញាំង	krɑ\.ɲaŋ
ក្រណាន់	krɑ\.nan
ក្រទាំង	krɑ\.teaŋ
ក្រពាត់	krɑ\.poat
ក្រមាច់	krɑ\.mac
ក្រមាល់	krɑ\.mal
ក្រវាត់	krɑ\.wat
ក្រវាន់	krɑ\.wan
ក្រសាំង	krɑ\.saŋ
ក្រស្នា	krɑ\.snaa
ក្រឡាច់	krɑ\.lac
ក្រឡាញ់	krɑ\.laɲ
ក្រឡាប់	krɑ\.lap
ក្រឡាស់	krɑ\.lah
គគ្រាក់	kɔ\.kreak
គគ្រាំង	kɔ\.kreaŋ
គន្លាក់	kun\.leak
គន្លាស់	kun\.loah
គម្រាំង	kum\.reaŋ
គ្រមាំង	krɔ\.meaŋ
គ្រវាត់	krɔ\.woat
គ្រស៊ែត	krɔ\.sɛɛt
ចង្កាក់	cɑŋ\.kak
ចង្វាក់	cɑŋ\.wak
ចង្ហាន់	cɑŋ\.han
ចន្ទាល់	cɑn\.toal
ចន្ទាស់	cɑn\.toah
ចម្ងាញ់	cɑm\.ŋaɲ
ចម្បាំង	cɑm\.ɓaŋ
ចម្រាញ់	cɑm\.raɲ
ចម្រាល់	cɑm\.ral
ចម្លាក់	cɑm\.lak
ចំប្រប់	cɑm\.prɑp
ចំប្រាវ	cɑm\.praaw
ច្រងាំង	crɑ\.ŋaŋ
ច្របាច់	crɑ\.ɓac
ច្រវាក់	crɑ\.wak
ច្រវាត់	crɑ\.wat
ច្រហាញ់	crɑ\.haɲ
ច្រហាំង	crɑ\.haŋ
ជញ្ជាត់	cuɲ\.coat
ជញ្ជាន់	cuɲ\.coan
ជញ្ជាប់	cuɲ\.coap
ជញ្ជាំង	cuɲ\.ceaŋ
ជញ្រ្ជំ	cuɲ\.rcum
ដង្កាប់	ɗɑŋ\.kap
ដង្ហាក់	ɗɑŋ\.hak
ដន្លាប់	ɗɑn\.lap
តន្ត្រំ	tɑn\.trɑm
តម្កាត់	tɑm\.kat
តម្រាប់	tɑm\.rap
តម្រាស់	tɑm\.rah
ត្រជាក់	trɑ\.ceak
ត្រដាល់	trɑ\.ɗal
ត្របាក់	trɑ\.ɓak
ត្របាញ់	trɑ\.ɓaɲ
ត្រប៉ក់	trɑ\.pɑk
ត្រប៉ិល	trɑ\.pəl
ត្រពាំង	trɑ\.peaŋ
ត្រលាត់	trɑ\.lat
ត្រលាំង	trɑ\.laŋ
ត្រសាប់	trɑ\.sap
ត្រសាល់	trɑ\.sal
ត្រស្ដិ	trɑ\.sɗeʔ
ទទ្រាក់	tɔ\.treak
ទន្ត្រំ	tun\.trɑm
ទន្ទាន់	tun\.toan
ទន្លាក់	tun\.leak
ទន្លាប់	tun\.loap
ទម្លាក់	tum\.leak
ទម្លាប់	tum\.loap
ទ្រនាប់	trɔ\.noap
ទ្រមាក់	trɔ\.meak
ទ្រមាំង	trɔ\.meaŋ
នខ្វាក់	nɔ\.kwak
បង្កាច់	ɓɑŋ\.kac
បង្កាត់	ɓɑŋ\.kat
បង្ខាំង	ɓɑŋ\.kʰaŋ
បង្គាប់	ɓɑŋ\.koap
បង្គ្រប	ɓɑŋ\.krɔɔp
បង្ហាត់	ɓɑŋ\.hat
បង្ហាប់	ɓɑŋ\.hap
បង្អាក់	ɓɑŋ\.ʔak
បង្អាប់	ɓɑŋ\.ʔap
បញ្ចាច់	ɓɑɲ\.cac
បញ្ចាល់	ɓɑɲ\.cal
បញ្ចាំង	ɓɑɲ\.caŋ
បញ្ច្រក	ɓɑɲ\.crɑɑk
បញ្ឆាច់	ɓɑɲ\.cʰac
បញ្ជាក់	ɓɑɲ\.ceak
បញ្ជាន់	ɓɑɲ\.coan
បញ្ជាប់	ɓɑɲ\.coap
បញ្ជ្រក	ɓɑɲ\.crɔɔk
បញ្រ្ជក	ɓɑɲ\.rcɔɔk
បណ្ដាក់	ɓɑn\.ɗak
បណ្ដាច់	ɓɑn\.ɗac
បន្ទាត់	ɓɑn\.toat
បន្ទាន់	ɓɑn\.toan
បន្ទាប់	ɓɑn\.toap
បន្ទាល់	ɓɑn\.toal
បន្ធាត់	ɓɑn\.tʰoat
បន្លាស់	ɓɑn\.lah
បន្សាក់	ɓɑn\.sak
បន្សាត់	ɓɑn\.sat
បន្សាល់	ɓɑn\.sal
បម្រាប់	ɓɑm\.rap
បម្រាស់	ɓɑm\.rah
បំប៉ាន់	ɓɑm\.pan
បំប្រួម	ɓɑm\.pruəm
បំប្លេង	ɓɑm\.pleeŋ
បំប្លែង	ɓɑm\.plaeŋ
បំប្លោង	ɓɑm\.plaoŋ
បំផ្លាង	ɓɑm\.plaaŋ
បំផ្លាញ	ɓɑm\.plaaɲ
បំផ្លិច	ɓɑm\.pləc
បំផ្លើស	ɓɑm\.plaəh
បំព្រាង	ɓɑm\.prieŋ
បំព្រាច	ɓɑm\.priec
បំព្រុល	ɓɑm\.prul
បំព្រួម	ɓɑm\.pruəm
បំភ្លាង	ɓɑm\.plieŋ
បំភ្លូក	ɓɑm\.pluuk
បំភ្លេច	ɓɑm\.pleec
ប៉ប៉ាច់	pɑ\.pac
ប៉ប្តៀច	pɑ\.ptiəc
ប៉ប្រាវ	pɑ\.praaw
ប៉ប្រិច	pɑ\.prəc
ប៉ប្រិញ	pɑ\.prəɲ
ប៉ប្រិម	pɑ\.prəm
ប៉ប្រិល	pɑ\.prəl
ប៉ប្រឹស	pɑ\.prəh
ប៉ប្រុក	pɑ\.prok
ប៉ប្រុន	pɑ\.pron
ប៉ប្រុយ	pɑ\.proj
ប៉ប្រូង	pɑ\.prooŋ
ប៉ប្រូច	pɑ\.prooc
ប៉ប្រូស	pɑ\.prooh
ប៉ប្រើស	pɑ\.praəh
ប៉ប្រេញ	pɑ\.preeɲ
ប៉ប្រេវ	pɑ\.preew
ប៉ប្រេះ	pɑ\.preh
ប៉ប្រែក	pɑ\.praek
ប៉ប្រែះ	pɑ\.praeh
ប៉ប្រោក	pɑ\.praok
ប៉ប្លក់	pɑ\.plɑk
ប៉ប្លាញ	pɑ\.plaaɲ
ប៉ប្លិក	pɑ\.plək
ប៉ប្លិច	pɑ\.pləc
ប៉ប្លឹក	pɑ\.plək
ប៉ប្លឺម	pɑ\.pləəm
ប៉ប្លុង	pɑ\.ploŋ
ប៉ប្លូក	pɑ\.plook
ប៉ប្លូច	pɑ\.plooc
ប៉ប្លើក	pɑ\.plaək
ប៉ប្លោញ	pɑ\.plaoɲ
ប៉ប្លោត	pɑ\.plaot
ប៉ផ្ងើក	pɑ\.pŋaək
ប៉ផ្ចប់	pɑ\.pcɑp
ប៉ផ្ញាញ	pɑ\.pɲaaɲ
ប៉ផ្ញោញ	pɑ\.pɲaoɲ
ប៉ផ្ដក់	pɑ\.pɗɑk
ប៉ផ្ដឺត	pɑ\.pɗəət
ប៉ផ្ដៀច	pɑ\.pɗiəc
ប៉ផ្អឹប	pɑ\.pʔəp
ប៉ផ្អឹះ	pɑ\.pʔəh
ប៉ផ្អុក	pɑ\.pʔok
ប៉ផ្អូក	pɑ\.pʔook
ប៉ផ្អូច	pɑ\.pʔooc
ប៉ផ្អួស	pɑ\.pʔuəh
ប៉ផ្អៀច	pɑ\.pʔiəc
ប៉ផ្អេះ	pɑ\.pʔeh
ប៉ផ្អែប	pɑ\.pʔaep
ប្រកាក់	prɑ\.kak
ប្រកាច់	prɑ\.kac
ប្រកាន់	prɑ\.kan
ប្រកាប់	prɑ\.kap
ប្រកាំង	prɑ\.kaŋ
ប្រគាក់	prɑ\.keak
ប្រចាក់	prɑ\.cak
ប្រចាប់	prɑ\.cap
ប្រឆាំង	prɑ\.cʰaŋ
ប្រជាន់	prɑ\.coan
ប្រជាប់	prɑ\.coap
ប្រញាប់	prɑ\.ɲap
ប្រញាល់	prɑ\.ɲal
ប្រដាក់	prɑ\.ɗak
ប្រដាន់	prɑ\.ɗan
ប្រដាប់	prɑ\.ɗap
ប្រដាល់	prɑ\.ɗal
ប្រណាំង	prɑ\.naŋ
ប្រថាប់	prɑ\.tʰap
ប្រទាក់	prɑ\.teak
ប្រទាល់	prɑ\.toal
ប្រទាស់	prɑ\.toah
ប្រទាំង	prɑ\.teaŋ
ប្រធាក់	prɑ\.tʰeak
ប្រផាត់	prɑ\.pʰat
ប្រផាប់	prɑ\.pʰap
ប្រពាក់	prɑ\.peak
ប្រមាញ់	prɑ\.maɲ
ប្រមាត់	prɑ\.mat
ប្រវាស់	prɑ\.wah
ប្រហាក់	prɑ\.hak
ប្រហាំង	prɑ\.haŋ
ប្រឡាក់	prɑ\.lak
ពង្រាក់	puŋ\.reak
ពង្រាត់	puŋ\.roat
ពញ្ញាក់	puɲ\.ɲeak
ពន្លាត់	pun\.loat
ពព្រាក់	pɔ\.preak
ពព្លាក់	pɔ\.pleak
ព្រងាល់	prɔ\.ŋoal
ព្រនាក់	prɔ\.neak
ព្រលាំង	prɔ\.leaŋ
មន្ត្រី	mun\.trəj
រង្គាត់	ruŋ\.koat
រង្វាន់	ruŋ\.woan
រង្វាល់	ruŋ\.woal
រង្វាស់	ruŋ\.woah
រណ្ដាប់	run\.ɗap
រន្ថាន់	run\.tʰan
រម្ងាប់	rum\.ŋoap
រម្ងាស់	rum\.ŋoah
វង្វាន់	wuŋ\.woan
សង្កាត់	sɑŋ\.kat
សង្ខ្យា	sɑŋ\.kjaa
សណ្ដាន់	sɑn\.ɗan
សណ្ដាប់	sɑn\.ɗap
សន្ធាប់	sɑn\.tʰoap
សន្ធ្យា	sɑn\.tjie
សន្លាក់	sɑn\.lak
សម្គាល់	sɑm\.koal
សម្គាំង	sɑm\.keaŋ
សម្ងាត់	sɑm\.ŋat
សម្នាក់	sɑm\.nak
សម្រាប់	sɑm\.rap
សម្រាស់	sɑm\.rah
សម្រាំង	sɑm\.raŋ
សម្លាញ់	sɑm\.laɲ
សម្លាប់	sɑm\.lap
សស្រាក់	sɑ\.srak
សស្រាញ់	sɑ\.sraɲ
សំព្រុស	sɑm\.pruh
សំស្ការ	sɑm\.skaa
ស្រងាត់	srɑ\.ŋat
ស្រដាស់	srɑ\.ɗah
ស្រទាប់	srɑ\.toap
ស្របាំង	srɑ\.ɓaŋ
ស្រប៉ាប	srɑ\.paap
ស្រប៉ូប	srɑ\.poop
ស្រប៉ើក	srɑ\.paək
ស្រប៉េក	srɑ\.peek
ស្រពាប់	srɑ\.poap
ស្រមាក់	srɑ\.mak
ស្រលាញ់	srɑ\.laɲ
ស្រវាំង	srɑ\.waŋ
ស្រឡាញ់	srɑ\.laɲ
ស្រអាប់	srɑ\.ʔap
ស្រអ៊ុក	srɑ\.ʔuk
ស្រអ៊ុម	srɑ\.ʔum
ស្រអ៊ុំ	srɑ\.ʔum
អង្កាញ់	ʔɑŋ\.kaɲ
អង្កាន់	ʔɑŋ\.kan
អង្កាល់	ʔɑŋ\.kal
អង្ក្រង	ʔɑŋ\.krɑɑŋ
អង្ក្រត	ʔɑŋ\.krɑɑt
អង្គ្រង	ʔɑŋ\.krɔɔŋ
អង្ឃាក់	ʔɑŋ\.kʰeak
អណ្ដាប់	ʔɑn\.ɗap
អន្ត្រត	ʔɑn\.trɑɑt
អន្ទាក់	ʔɑn\.teak
អន្ទ្រត	ʔɑn\.trɔɔt
អម្ចាស់	ʔɑm\.cah
កញ្ច្រង់	kɑɲ\.crɑŋ
កញ្ច្រឹក	kɑɲ\.crək
កញ្ច្រឺប	kɑɲ\.crəəp
កញ្ច្រែង	kɑɲ\.craeŋ
កញ្ជ្រក់	kɑɲ\.cruək
កញ្ជ្រឹល	kɑɲ\.crɨl
កញ្ជ្រូក	kɑɲ\.cruuk
កញ្ជ្រៀច	kɑɲ\.criəc
កញ្ជ្រៀប	kɑɲ\.criəp
កញ្ជ្រៀវ	kɑɲ\.criəw
កញ្ជ្រោក	kɑɲ\.crook
កញ្ជ្រោង	kɑɲ\.crooŋ
កញ្ជ្រោល	kɑɲ\.crool
កន្ត្រប់	kɑn\.trɑp
កន្ត្រាក	kɑn\.traak
កន្ត្រើយ	kɑn\.traəj
កន្ត្រែង	kɑn\.traeŋ
កន្ត្រោង	kɑn\.traoŋ
កន្ត្រោន	kɑn\.traon
កន្ទ្រង់	kɑn\.truŋ
កន្ទ្រាញ	kɑn\.trieɲ
កន្ទ្រាំ	kɑn\.troam
កន្ទ្រឹស	kɑn\.trɨh
កន្ទ្រុប	kɑn\.trup
កន្ទ្រុំ	kɑn\.trum
កន្ទ្រួក	kɑn\.truək
កន្ទ្រួប	kɑn\.truəp
កន្ទ្រើង	kɑn\.trəəŋ
កន្ទ្រែត	kɑn\.trɛɛt
កន្ទ្រោក	kɑn\.trook
ចង្ក្រង់	cɑŋ\.krɑŋ
ចង្ក្រត់	cɑŋ\.krɑt
ចង្ក្រាន	cɑŋ\.kraan
ចង្គ្រក់	cɑŋ\.kruək
ចង្គ្រាង	cɑŋ\.krieŋ
ចង្គ្រុង	cɑŋ\.kruŋ
ចង្គ្រោង	cɑŋ\.krooŋ
ទន្ទ្រាន	tun\.trien
ទន្ទ្រាម	tun\.triem
ទ្រទ្រង់	trɔ\.truŋ
បង្ក្រាប	ɓɑŋ\.kraap
បង្ក្រៀក	ɓɑŋ\.kriək
បង្គ្រប់	ɓɑŋ\.krup
បញ្ច្រាស	ɓɑɲ\.craah
បញ្ច្រិច	ɓɑɲ\.crəc
បញ្ច្រូច	ɓɑɲ\.crooc
បញ្ច្រោះ	ɓɑɲ\.crɑh
បញ្ជ្រាល	ɓɑɲ\.criel
បញ្ជ្រិះ	ɓɑɲ\.crih
បញ្ជ្រុល	ɓɑɲ\.crul
បញ្ជ្រួស	ɓɑɲ\.cruəh
បញ្រ្ជាប	ɓɑɲ\.rciep
បន្ទ្រេត	ɓɑn\.treet
បន្ទ្រោម	ɓɑn\.troom
បំព្រាត់	ɓɑm\.proat
បំភ្លាត់	ɓɑm\.ploat
បំភ្លាំង	ɓɑm\.pleaŋ
ប៉ប្រាច់	pɑ\.prac
ប៉ប្លាក់	pɑ\.plak
ប៉ប្លាច់	pɑ\.plac
ប៉ផ្ងាក់	pɑ\.pŋak
ប៉ផ្ញាច់	pɑ\.pɲac
ប្រគ្រីវ	prɑ\.kriiw
ប្រឆ្ងិត	prɑ\.cŋət
ប្រជ្រុយ	prɑ\.cruj
ប្រជ្រួស	prɑ\.cruəh
ប្រជ្រៀត	prɑ\.criət
ប្រឈ្លោះ	prɑ\.cluəh
ប្រផ្នូល	prɑ\.pnool
ប្រស្ដែង	prɑ\.sɗaeŋ
ប្រស្និត	prɑ\.snət
សង្ឃ្រាជ	sɑŋ\.kriec
សង្រ្គាជ	sɑŋ\.rkiec
សង្រ្គុប	sɑŋ\.rkup
អង្គ្រឺត	ʔɑŋ\.krɨɨt
អង្គ្លេស	ʔɑŋ\.kleeh
អន្ត្រឹក	ʔɑn\.trək
អន្ត្រុក	ʔɑn\.trok
អន្ត្រើក	ʔɑn\.traək
អន្ត្រោក	ʔɑn\.traok
អន្ទ្រក់	ʔɑn\.truək
អន្ទ្រាក	ʔɑn\.triek
អន្ទ្រាម	ʔɑn\.triem
អន្ទ្រឺត	ʔɑn\.trɨɨt
អន្ទ្រុក	ʔɑn\.truk
អន្ទ្រូត	ʔɑn\.truut
អន្ទ្រើត	ʔɑn\.trəət
អន្ទ្រើម	ʔɑn\.trəəm
កន្ត្រាក់	kɑn\.trak
ចង្គ្រាស់	cɑŋ\.kroah
ជញ្រ្ជាំង	cuɲ\.rceaŋ
បន្ទ្រាន់	ɓɑn\.troan
អន្ត្រាក់	ʔɑn\.trak
